### EXTRA those with NUMBER (â€¦2 etc) need to go to BOTTOM of file!!
# udug2    Å ITAâ‚‚
du@s 	ğ’½
ANx3 	ğ’€¯
KAÃ—LI 	ğ’…²  	Kehle  Äeli3 "throat; windpipe"  
harax 	Â¿  	cart-container
hurx 	ğ’…—Â·Â¿
hubur 	Â¿
huburx 	Â¿
esirx 	Â¿
lak173 	Â¿ 	 lacking / lacunae
lumx 	Â¿ 	 egg?
aÅ¡arid 	Â¿ erst
ala 	ğ’Œ·
alu 	ğ’Œ·  	ville
dama 	ğ’‚¼ 	d'ama dame <> Mama
dinana 	ğ’ˆ¹ 
akar	Â¿ 	gear "armor" @ guerre Akk. ğ’€Šğ’ˆ›ğ’Œ… 	ap-luá¸«-tu apluhtu
aah 	ğ’€€ğ’„´
utu 	ğ’Œ“
zabaraga  	ğ’Œ“ğ’Š•ğ’‡ğ’‚‡ 	utu-sag-bar-aga
zabar  	ğ’Œ“ğ’Š•ğ’‡ 	utu-sag-bar Zober (a vessel)
Å¡im 	ğ’‹†
Å¡em 	ğ’‹†
Å¡imaz 	ğ’‹†ğ’Š 
luzabar  	ğ’‡»ğ’Œ“ğ’Š•ğ’‡
lak589 	Â¿
LAK590 	Â¿
zin 	ğ’Š¿
áº“in 	ğ’‚” 
zin2 	ğ’‚” 
bre 	ğ’‚Š 
EF 	ğ’‚Š 
zze 	ğ’¢
iá¹£ 	ğ’„‘
iss 	ğ’„‘
takax 	ğ’† â‰ˆ ğ’‹º	TAK4
uga 	ğ’‚µ  GA
UZUGX 	ğ’…—ğ’Œ‘
zukum 	â‰ˆ ğ’Œğ’†¸ â‰ˆ ğ’‚ƒğ’†¸
rit 	ğ’‹ƒ 	# ridge â‰ˆ ğ’‹°ğ’ˆÌ² â‰ˆ ğ’‘Šğ’ˆÌ² â‰ˆ ğ’Š’ RUáµˆ 
pul 	ğ’‡§
av 	ğ’„ 
dum 	ğ’Œˆ
hup 	ğ’„½
war 	ğ’‡
ai 	ğ’€€ğ’€€
GÃšB 	ğ’†
GÃB 	ğ’†
murx 	ğ’Œ™
MURâ‚“ 	ğ’Œ™
AL 	ğ’€ 	
kÃ¹ 	ğ’„€
Ã‰ 	ğ’‚ 
Å E3 	ğ’‚  
Å¡Ã¨ 	ğ’‚ 
ZI3 	ğ’¥
zid2	ğ’¥
DÃ™ 	ğ’†•
áº“i 	ğ’¢ 	â‰ˆ ğ’‹°ğ’ºğ’ˆ« â‰ˆ ğ’Š â‰ˆ ğ’ºğ’‹°ğ’ˆ« â‰ˆ ğ’‹°ğ’ˆ« â‰ˆ ğ’‹› SI â‰ˆ á¹¢E ğ’¢
zzi 	ğ’¢ 	â‰ˆ ğ’‹°ğ’ºğ’ˆ« â‰ˆ ğ’Š â‰ˆ ğ’ºğ’‹°ğ’ˆ« â‰ˆ ğ’‹°ğ’ˆ« â‰ˆ ğ’‹› SI 
tap 	ğ’‹°
á¹¢A 	ğ’…• 	
á¹¢A2 	ğ’
ssa 	ğ’…• 	
ssu 	ğ’‹¢
á¹£e 	ğ’¢
sse 	ğ’¢
siq 	ğ’‹ 	â‰ˆ ğ’‹™ğ’‹™ 	â‰ˆ ğ’‚—
sig 	ğ’‹ 	â‰ˆ ğ’‹™ğ’‹™ 	â‰ˆ ğ’‚—
MIR 	ğ’‚‡ 
Å¡ap 	ğ’‰ºğ’… 
shap 	ğ’‰ºğ’… 
bel 	ğ’‚— 	 â‹ ğ’‰ºğ’‹¼ğ’‹›ğ’ƒ» Patesi â‰ˆ puzur > pa'ria > ğ’‚— Baal  
pah 	ğ’ˆœ
pah2 	ğ’†¦ğ’‹°
paá¸¥ 	ğ’†¦ğ’‹°
pak 	ğ’†¦ğ’‹°
pack 	ğ’†¦ğ’‹°
ay 	ğ’€€ğ’€€
dis 	ğ’‘°
dish 	ğ’‘°
diÅ¡ 	ğ’‘°
dash 	ğ’‘°
daÅ¡ 	ğ’‘°
nis 	ğ’™ 	ğ’Œ‹ğ’Œ‹
sad 	ğ’†³ 	saddle:mountain
suv 	ğ’‹³
va 	ğ’‘‘ 	ğ’€¼ğ’¹ 	ğ’€¾ â‹ ğ’‘“ â‰ˆ ğ’‘‘ 	 PA ğ± ~ ğ› FA ğº ğ’€€
ZUM 	ğ’® 
áº“u	ğ’®
á¹£u	ğ’®
ssu2	ğ’®
sak 	ğ’Š•
á¸¥ir 	ğ’‚¡
hir 	ğ’‚¡ 	ğ’†Ÿ
ha  	ğ’„©
qe  	ğ’†¥
bit 	ğ’‚ 	beith
ic 	 ğ’„‘
gis 	 ğ’„‘
tal 	ğ’Š‘
dal 	ğ’Š‘
liq 	ğ’Œ¨
lik 	ğ’Œ¨
GAS 	ğ’‘™ 
vas 	ğ’ˆ¦ 	maÅ¡
mas 	ğ’ˆ¦ 	
el 	ğ’‚–
lat 	ğ’†³ 	vs mat
idi 	ğ’€‰ 	IT ğ’• at ante 
ina 	ğ’€¸
suÅ™ 	ğ’ 
sur 	ğ’  â‰ˆ ğ’„® SUR3
sir 	ğ’‹“  	â‰ˆ ğ’ sir2
áº“ir 	ğ’‚” 	â‰  ğ’†° â‰  SIR2	ğ’ ğ’‹¤ 
zir 	ğ’‚”
Å¼ir 	ğ’‚”  	Eden
áº“in 	ğ’‚”  	á´±áº“in zone ğ’‚” 	EDIN â€œEdenâ€ 
sit 	ğ’ˆ©  	â‰ˆ ğ’‹°ğ’ˆÌ² â‰ˆ ğ’‹ƒ !?
saki 	ğ’Š•  	sag
sip 	ğ’ˆ¨
limut 	ğ’…†ğ’Œ¨ 	evil
limuti 	ğ’…†ğ’Œ¨ 	evil
mes 	ğ’Œ
mis 	ğ’Œ
he  	ğ’„­
dak 	ğ’–  	Dach
pur 	ğ’“
IS 	ğ’…– 
pis 	ğ’„«
ris 	ğ’Š•
qaq 	ğ’†•
á¹£u  	ğ’® 
aá¹£ 	ğ’Š 
Å¡u 	ğ’‹—
rum 	ğ’€¸ 	really?? in ğ’Œ¨ğ’€¸ğ’ ur-rum-bu ğ’ˆ¾ğ’‚µğ’€¸ na-ga-rum
mat 	ğ’†³ 
zab 	ğ’‚Ÿ
aq 	ğ’€
suk 	ğ’†¹
naÄ 	ğ’…˜  	nagen/nuckeln
nag 	ğ’…˜  	next/neighbor:
nak 	ğ’…˜  	enemy/hostile
qud 	ğ’‹»
qut 	ğ’‹»
kut 	ğ’‹»
pal 	ğ’„
kit 	ğ’†
qabal 	ğ’‰   	â€¢qarba coreba
MUQ 	ğ’ˆ® 
lak 	ğ’‹ƒ
ya 	ğ’„¿ğ’€€  	(ligature)
V 	ğ’Œ‹
1  	ğ’¹
3 	ğ’º
z 	ğ’ˆ«
yi 	ğ’€¸
P 	ğ’‰º
US	ğ’Š»
US2	ğ’‘
rad 	ğ’‹¥
rat 	ğ’‹¥
mit 	ğ’Œ€
Iâ‚‚ 	ğ’Š
I2 	ğ’Š
Ã 	ğ’Š
IÃ	ğ’Š
IA2 	ğ’Š
Å¡al 	ğ’Š©
qu 	ğ’†ª
QÃ­	ğ’† 
qÃ© 	ğ’„€  	? KE2
Å¡ah 	ğ’‹š
Å¡ap 	ğ’‰ºğ’…
qab 	ğ’ƒ®
TEM 	ğ’´
Å¡ur 	ğ’‹©
Å¡ib 	ğ’ˆ¨
sÃºn 	ğ’„¢
SUN2	ğ’„¢
SUN5	ğ’”	
SUN7	ğ’†—	
riÅ¡ 	ğ’Š•
Rash 	ğ’Š•
Ras 	ğ’Š•
RaÅ¡ 	ğ’Š•
SIG5  	ğ’‹Ÿ 
SHU2 	ğ’‹Ÿ 
Å¡Ãº 	ğ’‹™
mut 	ğ’‰¸
DUMU 	ğ’Œ‰
ÃŒR 	ğ’€´
ÃG 	ğ’‰˜
ENSI2 	ğ’‰ºğ’‹¼ğ’‹›
MÃ™Å  	ğ’ˆ¹  
# MUÅ 3  ğ’ˆ¹
d 	ğ’€­
IR	ğ’…•
lg 	â„¢
UK 	ğ’ŠŒ
Å¡Ã  	ğ’Š®
rÃ¡Å¡ 	ğ’Š•
zul 	ğ’‚„ 
Å UL 	ğ’‚„
Å¡Ã¡ 	ğ’ƒ»
IP 	ğ’…
tin 	ğ’·
tÃ©n 	ğ’·
DIN 	ğ’· 
DON 	ğ’·
IK 	ğ’…… 
BÃ 	ğ’‰ˆ 
ÃB	ğ’Œˆ
ÃP	ğ’Œˆ
H 	ğ’„´ 	Elamite coda consonant
ÃºH 	ğ’„´
taÅ¡ 	ğ’Œ¨
teÅ¡ 	ğ’Œ¨ 
tÃ¡h 	ğ’ˆ­
YA@ 	ğ¹
ZI2	ğ’¢
ZÃ	ğ’¢
Ã¡Å¡ 	ğ’€¸ 
MAN 	ğ’Œ‹ğ’Œ‹
Å¡il 	ğ’‹»
Ãº 	ğ’Œ‘
mÃ¡Å¡ 	ğ’ˆ§
tam 	ğ’Œ“
# PIR2 	ğ’•	
PÃR 	ğ’•	
Å¡ad 	ğ’†³ 
TÃš 	ğ’Œ…? 	ğ’‘Š TUâ‚‚ ?
bat 	ğ’
UP 	ğ’Œ’
rap 	ğ’Š
rÃ¡p 	ğ’Š?  	rap2?
RAB	ğ’Š
RÃ¡B	ğ’Š?
# DUR2	ğ’‚‰
DÃšR	ğ’‚‰ 	DUR	ğ’„™â€¦??
DUK 	ğ’‚ 
LAK 	ğ’½
KAS 	ğ’†œ
KÃS 	ğ’†œ?
MÃN	ğ’ˆ«? 	MIN3	ğ’Œ‹ğ’Œ‹
RAK	ğ’Š©
RÃK	ğ’Š©
ÃšR 	ğ’Œ«		UR2 	
KÃN	ğ’†? 	KAN4!	
tan 	ğ’º?
kap 	ğ’†
t 	ğ’‹«?
qat 	ğ’‹—
kip 	ğ’„’
GÃŒR 	ğ’„Š 	


A	ğ’€€
A'	ğ’„´
A2	ğ’€‰
A12	ğ’Œ“
AB	ğ’€Š  	 ABA ABBA	ğ’€Š Naun : know ğ’ª	window?	ğ’‰£ ABzu|Naun !
AB2	ğ’€–  	 cow â†” ğ’†¨ ğ“‹©ğ“¤ğ“ƒ’ğ“¥ ğ“ˆğ“ğ“„° ğ“„¤ğ“ğ“ƒ’ğ“¥ kette,kettle,gut,heart 
ABBA2	ğ’€‹
ABBUNUNNU	ğ’Œ“ğ’„·ğ’„­ğ’‰£	*
ABGAL	ğ’‰£ğ’ˆ¨	*
ABGAL2	ğ’‰£ğ’ˆ¨ğ’…¤	*
ABLAL	ğ’†¼
ABLAL3	ğ’‡¦
ABNI2	ğ’† ğ’‰ˆ	*
ABRIG	ğ’‰£ğ’ˆ¨ğ’º	*
ABRIG2	ğ’€–ğ’‰£ğ’ˆ¨ğ’º	*
ABSIN	ğ’† ğ’€¸ğ’€¸	*
ABSIN3	ğ’€³
ABUL	ğ’†ğ’ƒ²	*
ABULA	ğ’†ğ’ƒ²	*
ABZU	ğ’ªğ’€Š	*
ABZUX	ğ’Œ¤
AD	ğ’€œ
AD2	ğ’„‰
AD3	ğ’‡¼
AD4	ğ’
AD5	ğ’Œ‘ğ’„‰	*
AD6	ğ’‡¿
ADX	ğ’ˆ•
ADX	ğ’‰
ADX	ğ’ğ’‡½	*
ADX	ğ’‡½ğ’ƒµ	*
ADAB	ğ’Œ“ğ’‰£	*
ADAMA	ğ’ğ’ˆª	*
ADAMIN	ğ’ˆ“
ADAMIN2	ğ’ˆ˜
ADAMIN3	ğ’„’
ADAMIN4	ğ’‰«
ADAMIN5	ğ’‚›
ADAMINX	ğ’‚œ
ADAMINX	ğ’‡½ğ’‡½	*
ADDA	ğ’‡¿
ADDA2	ğ’‡¼
ADDAX	LU2 gunÃ» UÅ 2
ADDIR	ğ’€€ğ’‰ºğ’„ğ’‰»ğ’‹›ğ’€€	*
ADDIRX	ğ’„ğ’‰»ğ’‹›	*
ADDIRX	ğ’‰ºğ’„ğ’‹›ğ’€€	*
ADDIRX	ğ’‰ºğ’„ğ’‹›ğ’€€ğ’‰»	*
ADDIRX	A LAK589 SI
ADDIRX	LAK589 A SI
ADDIRX	LAK589 PAD SI
ADDIRX	LAK589 SI
ADDIRX	LAK589 SI A
ADDIRX	LAK590 SI
ADKIN	ğ’‹ ğ’‡´	*
ADKINX	ğ’‹	Å Ã‰Å  (SÃG.LAM)
AG	ğ’€
AG2	ğ’‰˜
AGA	ğ’‚‡
AGA3	ğ’‚†
AGAM	ğ’€‚
AGAR2	ğ’‡‹
AGAR3	ğ’†»
AGAR4	ğ’…Š
AGARGARA	ğ’‰©
AGARIN	ğ’€Œ
AGARIN2	ğ’€
AGARIN3	ğ’‚¼ğ’‚†	*
AGARIN4	ğ’‚¼ğ’‹†	*
AGARIN5	ğ’‚¼ğ’‹‹	*
AGARINX	ğ’€
AGARINX	ğ’‡‰
AGRIG	ğ’…†ğ’¾	*
AGRUN	ğ’‚ğ’‰£	*
AÄœ2	ğ’‰˜
AÄœA3	ğ’‚†
AÄœAR5	ğ’…
AÄœAR6	ğ’…ğ’‚‚	*
AÄœARIN	ğ’€Œ
AÄœARIN2	ğ’€
AÄœARIN3	ğ’‚¼ğ’‚†	*
AÄœARIN4	ğ’‚¼ğ’‹†	*
AÄœARIN5	ğ’‚¼ğ’‹‹	*
AÄœARINX	ğ’€
AÄœARINX	ğ’‡‰
AÄœRIG	ğ’…†ğ’¾	*
Aá¸ª	ğ’„´
Aá¸ª3	ğ’Œ“
Aá¸ª6	ğ’Œ”
AK	ğ’€
AKA3	ğ’‹ƒ
AKAN	ğ’›
AKKAN3	ğ’‡–
AKKIL	ğ’ƒ°ğ’‹ºğ’‹›	*
AKKIL2	ğ’€œğ’†¤	*
AKKILX	ğ’€œğ’†ª	*
AKKILX	ğ’ƒ°ğ’‹ºğ’‹›ğ’€€	*
AKTUM	ğ’€€ğ’‹¢	*
AKTUM2	ğ’‹¢ğ’€€	*
AL	ğ’€ 
ALAD	ğ’†˜
ALAD2	ğ’†—
ALAL	ğ’‹„
ALAL3	ğ’„’
ALAL4	ğ’ƒº
ALAN	ğ’€©
ALGAMEÅ 	ğ’Œ“ğ’Š©ğ’„¸	*
ALIM	ğ’„‹
ALLA	ğ’‰„
ALURAX	ğ’ƒ
AM	ğ’„ 
AM3	ğ’€€ğ’€­	*
AM6	ğ’€­

AMA	ğ’‚¼ Mama : mother!!	ğ’‚·*ğ’€­ Gaia?
AMA5	ğ’ƒ£
AMAGI	ğ’ˆ» ^^ ğ’ˆ¹ mother!
AMAGI2	ğ’€€ğ’ˆ¹ğ’²	*	mAma-Gaia?
AMAGI3	ğ’ğ’ˆ¹ğ’²	*
AMAGIX	ğ’€€ğ’ˆ¹ğ’€€ğ’²	*
AMALU	ğ’‚¼ğ’€­ğ’ˆ¹	*
AMALUG	ğ’‚¼ğ’ˆ¹	*

AMAN	ğ’‰½ğ’‰½	*
AMAR	ğ’€«
AMAÅ 	ğ’¦
AMBAR	ğ’†¹
AMRA	ğ’„‘ğ’ˆ£ğ’Š	*
AMUÅ 	ğ’€‡
AN	ğ’€­ 	Astar, Ast!, Ã„hre, Ehre, Herr, All=El=Ilumi!
ANÅ E	ğ’€²
ANZALUB	ğ’Š®ğ’„€	*
ANZU2	ğ’€­ğ’…ğ’ˆª	*
ANZUD	ğ’€­ğ’…ğ’‚‚	*
ANZUD2	ğ’€­ğ’…ğ’ˆª	*
AP	ğ’€Š
APIN	ğ’€³
AR	ğ’…ˆ
AR2	ğ’„±
AR3	ğ’„¯
ARX	ğ’Œ¸
ARA	ğ’Š­
ARA3	ğ’„¯
ARA5	ğ’„¯ğ’„¯
ARAD	ğ’€´
ARAD2	ğ’€µ
ARAá¸ª3	ğ’ƒ¥
ARAá¸ª4	ğ’‚ğ’‘ğ’ğ’•	*
ARAá¸ªX	ğ’‘ğ’ğ’•	*
ARALI	ğ’‚ğ’†³ğ’ˆª	*
ARALIX	ğ’Œ½
ARATTA	ğ’‡¶
ARATTAX	ğ’‡´ğ’†³ğ’Š’ğ’•	*
ARGAB	ğ’€¶
ARá¸ªUÅ 	ğ’ƒ£
ARá¸ªUÅ 2	ğ’‰¦
ARI2	ğ’…‚
ARINA	ğ’ˆ¸ğ’€€ğ’ˆ¾	*
ARINAX	ğ’„¿ğ’ˆ•ğ’ˆ¾	*
ARINAX	ğ’ˆ•ğ’ˆ¾	*
ARINAX	ğ’Œ«ğ’€€	*
ARKAB	ğ’ƒ»ğ’…	*
ARKAB2	ğ’€¶
ARKABX	ğ’€¶ğ’…	*
AS	ğ’Š
AS4	ğ’
ASAL2	ğ’€€ğ’Œ…ğ’ƒ®ğ’‡º	*
ASALX	ğ’€·
ASALX	ğ’€€ğ’Œ…	*
ASALX	ğ’€€ğ’Œ…ğ’ƒ®ğ’‹ğ’ƒ»	*
ASALX	ğ’€€ğ’Œ…ğ’‰ª	*
ASIL	ğ’‚°
ASIL3	ğ’‚¢
ASILX	ğ’‚¡
ASILA	ğ’‚°
ASILA3	ğ’‚¢
ASILAX	ğ’‚¬
ASILAL	ğ’‚°
ASILAL3	ğ’‚¢
ASILAL4	ğ’‚¤
ASLUMX	ğ’€€ğ’ˆ	*
AÅ 	ğ’€¸
AÅ 2	ğ’€¾
AÅ 3	ğ’‹
AÅ 5	ğ’‹ ğ’‡´ğ’‹¦	*
AÅ AG	ğ’ƒ·
AÅ GAB	ğ’€¿
AÅ GABGALX	ğ’ƒ²ğ’€¿	*
AÅ KI	ğ’¤ğ’†¸	*
AÅ KUD	ğ’€¾ğ’ˆ½	*
AÅ KUD2	ğ’€¾ğ’ˆ¹	*
AÅ LUG	ğ’‚ğ’‘ğ’ğ’•	*
AÅ NAN	ğ’Šº
AÅ NAN2	ğ’Šºğ’Œ	*
AÅ Å A2	ğ’ƒ°ğ’‹º	*
AÅ TA	ğ’ƒ°ğ’‹º	*
AÅ TE	ğ’€‰ğ’Œ‹ğ’†¤	*
AÅ TE2	ğ’†¹
AT	ğ’€œ
AU	ğ’€€ğ’‰ºğ’„ğ’‰»ğ’‹›ğ’€€	*
AYA	ğ’€€ğ’€€	*
AYA2	ğ’€€
AYA4	ğ’†¹
AYAYAX	ğ’€€ğ’€€ğ’€€	*
AZ	ğ’Š
AZADX	ğ’€€ğ’‡‰ğ’‹™	*
AZAG	ğ’†¬ğ’€­	*
AZLAG	ğ’Œ†ğ’Œ“	*
AZLAG3	ğ’„‘ğ’Œ†ğ’‰¿ğ’‹¼ğ’€€ğ’º	*
AZLAG4	ğ’„‘ğ’Œ†ğ’‹¼ğ’€€ğ’º	*
AZLAG5	ğ’„‘ğ’Œ†ğ’‰¿ğ’‹¼ğ’€€	*
AZLAG7	ğ’ˆ
AZLAGGALX	ğ’ƒ²ğ’„‘ğ’Œ†ğ’‹¼ğ’€€ğ’º	*
AZU	ğ’¬
AZUGNA	ğ’„¯ğ’Š•	*
BA	ğ’€
BA4	ğ’‚·
BA13	ğ’ˆ¨
BABBAR	ğ’Œ“
BABBAR2	ğ’Œ“ğ’Œ“	*
BAD	ğ’
BAD3	ğ’‚¦
BAG3	ğ’‚
BAá¸ªAR2	ğ’ƒ
BAL	ğ’„
BALA	ğ’„
BALAG	ğ’†
BAN3	ğ’Œ‰
BANDA3	ğ’Œ‰
BANÅ UR	ğ’
BAPPIR	ğ’‹‹
BAR	ğ’‡
BAR2	ğ’ˆ
BAR7	ğ’‰ˆ
BARA2	ğ’ˆ
BARGI	ğ’Œ
BAZBAZX	ğ’Š»
BE	ğ’
BE2	ğ’‰
BE3	ğ’‰Œ
BE7	ğ’‰ˆ
BI	ğ’‰
BI2	ğ’‰ˆ
BIL	ğ’‰ˆ
BIL2	ğ’‰‹
BIR	ğ’„µ
BIR4	ğ’‚”
BIR5	ğ’‰†
BIR6	ğ’Š¶
BIÅ EBA3	ğ’„¡
BU	ğ’
BUGIN	ğ’†¹
BUL	ğ’‡§
BULUG	ğ’‘
BUN2	ğ’…®
BUNIN	ğ’†¹
BUR	ğ’“
BUR2	ğ’”
BUR3	ğ’Œ‹
BUR10	ğ’‡§
BUR12	ğ’
BURANUN	ğ’Œ“ğ’„’ğ’‰£	*
BURANUNX	ğ’„’ğ’‰£	*
BURANUNA	ğ’Œ“ğ’„’ğ’‰£	*
BURU4	ğ’‰¢ğ’“	*
BURU14	ğ’‚™
DA	ğ’•
DA2	ğ’‹«
DA3	ğ’†•
DAB	ğ’³
DAB5	ğ’†ª
DAB6	ğ’
DADAG	ğ’Œ“ğ’Œ“	*
DAG	ğ’–
DAG3	ğ’´
DAGRIM	ğ’‡‘
DAá¸ª	ğ’ˆ­
DAL	ğ’Š‘
DALLA	ğ’ˆ¦ğ’„˜ğ’ƒ¼	*
DAM	ğ’®
DAN2 	ğ’ƒ‰ 	â‰ˆ DGEN ğ’‚·
DAN3	ğ’ƒ©
DAN4	ğ’ƒ‹
DAR	ğ’¯
DAR3	ğ’°
DARA3	ğ’°
DARA4	ğ’±
DE2	ğ’Œ¤
DE3	ğ’‰ˆ
DE6	ğ’º
DI	ğ’²
DI4	ğ’Œ‰
DIB	ğ’³
DID	ğ’…
DIDLI	ğ’€
DIG	ğ’‰Œ
DIÄœIR	ğ’€­
DILI	ğ’€¸
DILIM2	ğ’‡º
DILMUN	ğ’‰Œğ’Œ‡	*
DIM	ğ’´
DIM2	ğ’¶
DIN	ğ’·
DIR	ğ’‹›ğ’€€	*
DIÅ 	ğ’¹
DU	ğ’º
DU2	ğ’Œ…
DU3	ğ’†•
DU6	ğ’‡¯
DU7	ğ’ŒŒ
DU8	ğ’‚ƒ
DU11	ğ’…—
DU12	ğ’Œ‡
DU17	ğ’‰ˆ
DUB	ğ’¾
DUB2	ğ’‚€
DUB3	ğ’„­
DUBUR2	ğ’„¶
DUG	ğ’‚
DUG3	ğ’„­
DUG4	ğ’…—
DUGUD	ğ’‚‚
DUá¸ª	ğ’‚ƒ
DUL	ğ’Œ‹ğ’Œ†	*
DUL3	ğ’Š¨
DUL7	ğ’Š•
DULX	ğ’Œ¨ğ’€€		*
DUMU	ğ’Œ‰
DUN	ğ’‚„
DUN3	ğ’‚…
DUR	ğ’„™
DUR2	ğ’‚‰
DUR3	ğ’€²ğ’€´	*
DUR7	ğ’
DUR10	ğ’Š¿
DURU2	ğ’†ª
DURU5	ğ’€€
DURUN	ğ’‚‰
DURUNX	ğ’†ªğ’†ª	*
DUSU2	ğ’€²ğ’…†ğ’‚ 	*
E	ğ’‚Š
E2	ğ’‚
E3	ğ’Œ“ğ’º	*
E4	ğ’€€
EA	ğ’€€
ED	ğ’€‰
ED2	ğ’Œ“ğ’º	*
ED3	ğ’‡¯ğ’º	*
EDEN	ğ’‚”
EDIMX	ğ’‚”
EDIN	ğ’‚”
EDURU	ğ’€
EGARA	ğ’ƒŒ
EGIR	ğ’‚•
EGIR2	ğ’‚ 
EGIR5	ğ’ˆ
EGIR6	ğ’ˆ±
EÄœ3	ğ’‰˜
EÄœER	ğ’‚•
EÄœIR	ğ’‚•
EÄœIR5	ğ’ˆ
EÄœIR6	ğ’ˆ±
Eá¸ª	ğ’„´
Eá¸ª3	ğ’†ªğ’†ª	*
EL	ğ’‚–
EM	ğ’…
EM3	ğ’‰˜
EMX	ğ’€€ğ’€­	*
EME	ğ’…´
EME4	ğ’‚¼
EME5	ğ’Š©ğ’„¸	*
EMEDA	ğ’Œğ’ˆ¨	*
EMEDU	ğ’‚¼ğ’Œ…	*
EMEDU2	ğ’‚¼ğ’€€ğ’Œ…	*
EN	ğ’‚—
EN3	ğ’‡·
EN6	ğ’…”
EN8	ğ’Š­
ENEGIR	ğ’…
ENEGIR3	ğ’‚—ğ’¶ğ’¼	*
ENGAR	ğ’€³
ENGUR	ğ’‡‰
ENKAR	ğ’‚™
ENMEN	ğ’†‰
ER	ğ’…•
ER2	ğ’€€ğ’…†	*
EREM	ğ’‚Ÿ
EREN	ğ’‚
EREN2	ğ’‚Ÿ
ERI	ğ’Œ·
ERIM	ğ’‚Ÿ
ERIM2	ğ’‰ˆğ’Š’	*
ERIM3	ğ’Œ¿
ERIN	ğ’‚
ERIN2	ğ’‚Ÿ
ERINX	ğ’ˆ¶
ERINA8	ğ’ˆ·
ERINA8	ğ’ˆ¸ğ’€€ğ’ˆ¾	*
ES	ğ’€
ES2	ğ’Œ
ESAG2	ğ’ƒ¥
ESI	ğ’†—
EÅ 	ğ’Œ
EÅ 2	ğ’‚ 
EÅ 3	ğ’€Š
EÅ 4	ğ’¹
EÅ 16	ğ’€¼
EÅ E2	ğ’‚ 
EÅ EMEN	ğ’† ğ’‚Šğ’‰ˆğ’²	*
EÅ EMEN2	ğ’† ğ’‚Šğ’‰ˆğ’²ğ’€­ğ’ˆ¹	*
EÅ GAR	ğ’€¾ğ’ƒ¼	*
EÅ TUB	ğ’„
ET	ğ’€‰
EZEN	ğ’‚¡
EZIM2	ğ’Šºğ’Œ	*
EZINA2	ğ’Šºğ’Œ	*
EZINA3	ğ’Œ
GA	ğ’‚µ
GA14	ğ’…—
GA2	ğ’‚·
GAB	ğ’ƒ®
GABA	ğ’ƒ®
GAD	ğ’ƒ°
GADA	ğ’ƒ°
GAG	ğ’†•
GAL	ğ’ƒ²
GAL2	ğ’……
GAL4	ğ’Š©
GAL5	ğ’‹¼
GALA	ğ’‘ğ’†ª	*
GALAM	ğ’ƒ´
GALGA	ğ’ƒŒ
GAM	ğ’ƒµ
GAM3	ğ’‰½ğ’ˆ¿	*
GAN	ğ’ƒ¶
GAN2	ğ’ƒ·
GANA2	ğ’ƒ·
GANBA	ğ’† ğ’‡´	*
GANUN	ğ’ƒ 
GAR	ğ’ƒ»
GAR3	ğ’ƒ¼
GAR5	ğ’ˆ–
GAR8	ğ’‹
GARADIN9	ğ’Œ
GARADINX	ğ’ƒ±
GARIM	ğ’‡‘
GAÅ AM	ğ’‰£ğ’ˆ¨ğ’‹³	*
GAÅ AN	ğ’ƒ½
GAZ	ğ’„¤
GAZI	ğ’ƒ¢
GAZI2	ğ’ƒ¨
GE	ğ’„€
GE2	ğ’†¤
GE6	ğ’ˆª
GE22	ğ’€º
GE23	ğ’€¹
GEL	ğ’„ƒ
GEME2	ğ’Š©ğ’†³	*
GEN6	ğ’„€
GENNA	ğ’Œ‰ğ’¹	*
GEÅ 	ğ’„‘
GEÅ Å IM	ğ’„‘ğ’‹†	*
GEÅ TIN	ğ’ƒ¾
GI	ğ’„€
GI2	ğ’†¤
GI4	ğ’„„
GI5	ğ’† 
GI6	ğ’ˆª
GI7	ğ’‚ 
GI16	ğ’„ƒ
GI17	ğ’¼
GIB	ğ’„ƒ
GIBIL	ğ’‰‹
GIBIL2	ğ’‹™ğ’€¾	*
GIBIL4	ğ’‰ˆ
GID2	ğ’
GIDIM	ğ’„‡
GIG	ğ’¼
GIG2	ğ’ˆª
GIGAM	ğ’ˆ“
GIGGI	ğ’ˆª
GIGI	ğ’„…
GIGIR	ğ’‡€
GIGIR2	ğ’‡¥
GIGIRX	ğ’†¸ğ’Œ€	*
GIL	ğ’„ƒ
GILGAMEÅ 	ğ’„‘ğ’‚†ğ’ˆ¦	*
GILGAMEÅ 2	ğ’„‘ğ’‰‹ğ’‚µğ’ˆ©	*
GILIM	ğ’„ƒ
GIM	ğ’¶
GIN	ğ’º
GIN2	ğ’‚†
GIN3	ğ’†³
GIN4	ğ’¤ğ’†¸	*
GIN6	ğ’„€
GIN7	ğ’¶
GIR	ğ’„«
GIR2	ğ’„ˆ
GIR3	ğ’„Š
GIR4	ğ’Œ‹ğ’€œ	*
GIR5	ğ’½
GIR6	ğ’¼
GIR10	ğ’‰ˆ
GIR15	ğ’‚ 
GIRABA	ğ’€Šğ’„«	*
GIRI16	ğ’„Œ
GIRI17	ğ’…—
GISAL	ğ’„
GIÅ 	ğ’„‘
ÄœEÅ 	ğ’„‘
GU	ğ’„–
GU2	ğ’„˜
GU3	ğ’…—
GU4	ğ’„
GU7	ğ’…¥
GUB	ğ’º
GUB2	ğ’‡·
GUD	ğ’„
GUD3	ğ’Œ‘ğ’† ğ’‹§ğ’‚µ	*
GUG	ğ’ğ’„¢	*
GUG2	ğ’ˆ–
GUL	ğ’„¢
GUM	ğ’„£
GUN3	ğ’¯
GUR	ğ’„¥
GUR2	ğ’ƒµ
GUR4	ğ’†¸
GUR5	ğ’€
GUR7	ğ’„¦
GUR8	ğ’‹½
GUR10	ğ’†¥
GUR11	ğ’‚µ
GUR17	ğ’„•
GURU5	ğ’€
GURU6	ğ’ƒ¸
GURU7	ğ’„¦
GURUD	ğ’‰©ğ’† 	*
GURUD2	ğ’‡½ğ’† 	*
GURUM	ğ’ƒµ
GURUN	UÅ 2 squared (four opposing ğ’— forming a square in the middle)
GURUÅ 	ğ’„¨
GURUÅ 3	ğ’€
ÄœA2	ğ’‚·
ÄœAL2	ğ’……
ÄœAR	ğ’ƒ»
ÄœARIN	ğ’‡‘
ÄœARZA	ğ’‰ºğ’€­	*
ÄœARZA2	ğ’‰ºğ’ˆ—	*
ÄœE26	ğ’‚·
ÄœEN	ğ’º
ÄœEÅ HAÅ HUR	ğ’„‘ğ’ˆ¢	*
ÄœEÅ Å IM	ğ’„‘ğ’‹†	*
ÄœEÅ TIN	ğ’ƒ¾
ÄœEÅ TUG3	ğ’„‘ğ’‰¿ğ’Œ†	*
ÄœI6	ğ’ˆª
ÄœI25	ğ’‚‚
ÄœIDLAM	ğ’Š©ğ’‘ğ’®	*
ÄœIDLAM2	ğ’‘ğ’®	*
ÄœIDLAM3	ğ’‘ğ’Š©ğ’®	*
ÄœIDRU	ğ’‰º
ÄœIR2	ğ’„ˆ
ÄœIRI3	ğ’„Š
ÄœISSU	ğ’„‘ğ’ˆª	*
ÄœIÅ 	ğ’„‘
ÄœIÅ GAL	ğ’‡
ÄœIÅ KIM	ğ’…†ğ’¾	*
ÄœIÅ NIMBAR	ğ’Š·
ÄœIZZAL	ğ’„‘ğ’Œ†ğ’‰¿ğ’“ğ’‰£	*
ÄœU10	ğ’ˆ¬
ÄœURUÅ 	ğ’†—
á¸ªA	ğ’„©
á¸ªABRUD	ğ’†¢
á¸ªAD2	ğ’Œ“
á¸ªAL	ğ’„¬
á¸ªAR	ğ’„¯
á¸ªASá¸ªUR	ğ’ˆ¢
á¸ªAÅ 	ğ’‹»
á¸ªAÅ 2	ğ’¨
á¸ªAÅ 4	ğ’®
á¸ªE2	ğ’ƒ¶
á¸ªI	ğ’„­
á¸ªIRINX	ğ’†¶
á¸ªU	ğ’„·
á¸ªUB	ğ’„½
á¸ªUB2	ğ’„¸
á¸ªUD2	ğ’Œ“
á¸ªUÄœ	ğ’‚ 
HU 	ğ’Œ¨
á¸ªUL	ğ’…†ğ’Œ¨	*
á¸ªUL2	ğ’„¾
á¸ªULU	ğ’…†ğ’Œ¨	*
á¸ªULUá¸ª	ğ’ˆ›
á¸ªUM	ğ’ˆ
á¸ªUR	ğ’„¯
á¸ªUÅ 	ğ’„­ğ’„Š	*
á¸ªUÅ (LAK240)	ğ’½
I	ğ’„¿
I3	ğ’‰Œ
IA	ğ’…€
IA3	ğ’‰Œ
IB	ğ’…
IB2	ğ’Œˆ
ID	ğ’€‰
ID2	ğ’€€ğ’‡‰	*
IDIGNA	ğ’ˆ¦ğ’„˜ğ’ƒ¼	*
IDIM	ğ’…‚
IG	ğ’……
IGI	ğ’…†
IGIÅ TU	ğ’…†ğ’º	*
IÄœ3	ğ’‰˜
Iá¸ª	ğ’„´
IL	ğ’…‹
IL2	ğ’…
IL3	ğ’€­
IM	ğ’…
IM2	ğ’½
IMIN	ğ’…“
IMMA3	ğ’…Š
IMMAX	ğ’‡‹
IMMAL	ğ’‰¥
IN	ğ’…”
INANA	ğ’ˆ¹
INANNA	ğ’ˆ¹
INIM	ğ’…—
INNIN	ğ’ˆ¹
IQ	ğ’……
IR	ğ’…•
IR3	ğ’€´
IR11	ğ’€µ
IRI	ğ’Œ·
IRI12	ğ’€Š
IS3	ğ’€Š
ISIMU3	ğ’Œ‹ğ’€œ	*
ISIMUD4	ğ’‰½ğ’…Šğ’‰£ğ’ˆ¨	*
ISIMUDX	ğ’‰½ğ’‰£ğ’ˆ¨ğ’‚¡	*
ISIN2	ğ’…”
IÅ 	ğ’…–
IÅ IB	ğ’ˆ¨
IÅ IN	ğ’‰ºğ’Šº	*
IÅ KUR	ğ’…
IT	ğ’€‰
ITI	ğ’Œš
ITI7	ğ’Œ—ğ’€­ğ’‹€ğ’† 	*
ITID	ğ’Œ—
ITIMA	ğ’ƒŸ
ITIMA2	ğ’Œ–
Iá¹¬	ğ’€‰
IZ	ğ’„‘
IZI	ğ’‰ˆ
IZIN	ğ’‚¡
KA	ğ’…—
KA2	ğ’†
KA3	ğ’‚µ
KA5	ğ’ˆœ
KAB	ğ’†
KAD2	ğ’†
KAD3	ğ’†‘
KAD4	ğ’†’
KAD5	ğ’†“
KAK	ğ’†•
KAL	ğ’†—
KALAG	ğ’†—
KALAM	ğ’Œ¦
KAM	ğ’„°
KAM2	ğ’†š
KAM4	ğ’†›
KAN	ğ’ƒ¶
KAN4	ğ’†
KAR	ğ’‹¼ğ’€€	*
KAR2	ğ’ƒ¸
KARKARA	ğ’…
KASKAL	ğ’†œ
KAÅ 4	ğ’½
KE	ğ’† 
KE2	ğ’„€
KEÅ 2	ğ’†Ÿ
KEÅ 3	ğ’‹™ğ’€­ğ’„²	*
KEÅ DA	ğ’‚¡
KI	ğ’† 
KI2	ğ’„€
KIBIR2	ğ’‹™ğ’€¾	*
KID	ğ’†¤
KID2	ğ’‹º
KIÄœ2	ğ’†¥
KIM3	ğ’
KIN	ğ’†¥
KINDA	ğ’ƒ±
KINDAGAL2	ğ’ƒ²ğ’Œµ	*
KINGAL	ğ’ƒ²ğ’Œº	*
KIR4	ğ’…—
KIR6	ğ’€˜
KIRI6	ğ’Š¬
KISAL	ğ’†¦
KISIM5	ğ’†¨
KISLAá¸ª	ğ’† ğ’Œ“	*
KIÅ 	ğ’†§
KIÅ I6	ğ’Š¾
KIÅ I8	ğ’
KIÅ I16	ğ’Œ‘ğ’„‰	*
KIÅ I17	ğ’„‰
KU	ğ’†ª
KU3	ğ’†¬
KU4	ğ’†­
KU5	ğ’‹»
KU6	ğ’„©
KU7	ğ’†¯
KUD	ğ’‹»
KUG	ğ’†¬
KUL	ğ’†°
KUM	ğ’„£
KUM2	ğ’‰ˆ
KUN	ğ’†²
KUN4	ğ’„¿ğ’‡»	*
KUP4	ğ’†¤
KUR	ğ’†³
KUR2	ğ’‰½
KURKU2	ğ’…—ğ’€­ğ’‰Œğ’‹›	*
KURUM7	ğ’…†ğ’‚Ÿ	*
KUÅ 	ğ’‹¢
KUÅ 2	ğ’Š¨
KUÅ 3	ğ’Œ‘
KUÅ U	ğ’Œ‹ğ’ŠŠ	*
KUÅ U2	ğ’†µ
KUÅ U4	ğ’Š¨
KUÅ UM4	ğ’Œ‹ğ’ŠŠ	*
LA	ğ’†·
LA2	ğ’‡²
LAG	ğ’‹ƒ
LAGAB	ğ’†¸
LAGAR	ğ’‡¬
LAGAR3	ğ’Š©ğ’„¸	*
LAGAÅ 	ğ’‰¢ğ’“ğ’†·	*
LAá¸ª4	ğ’»
LAá¸ªÅ U	ğ’‡±
LAá¸ªTAN	ğ’‰´
LAá¸ªTAN2	ğ’‰¶
LAL	ğ’‡²
LAL3	ğ’‹­
LAM	ğ’‡´
LAM2	ğ’‰ˆ
LAMMA	ğ’†—
LE	ğ’‡·
LE2	ğ’‰Œ
LEM4	ğ’‰ˆ
LI	ğ’‡·
LI2	ğ’‰Œ
LI9	ğ’‰ˆ
LIB	ğ’ˆœ
LIBIR	ğ’…†ğ’‚ 	*
LIBIÅ 	ğ’€š
LID	ğ’€–
LID2	ğ’‰Œ
LIGIMA	ğ’…†ğ’Œ‰ğ’Œ‰	*
LIL	ğ’‡¸
LIL2	ğ’†¤
LILIZ	ğ’€—
LIM	ğ’…†
LIMMU2	ğ’‡¹
LIÅ 	ğ’‡º
LU	ğ’‡»
LU2	ğ’‡½
LU3	ğ’ˆ–
LUB	ğ’ˆœ
LUG	ğ’‡»
LUGAL	ğ’ˆ—
LUGUD3	ğ’ˆŸ
LUá¸ª	ğ’ˆ›
LUL	ğ’ˆœ
LUM	ğ’ˆ
LUNGA3	ğ’‹‹
MA	ğ’ˆ 
MA2	ğ’ˆ£
MA3	ğ’‚·
MAá¸ª	ğ’ˆ¤
MAR	ğ’ˆ¥
MAÅ 	ğ’ˆ¦
MAÅ 2	ğ’ˆ§
MAÅ 3	ğ’ˆ¦ğ’‰º	*
MAÅ GI	ğ’Œ
ME	ğ’ˆ¨
ME3	ğ’€
MEN	ğ’ƒ
MEN2	ğ’ˆ¨
MES	ğ’ˆ©
MEÅ 	ğ’Œ
MI	ğ’ˆª
MI2	ğ’Š©
MIN	ğ’ˆ«
MIN3	ğ’Œ‹ğ’Œ‹	*
MITUM2	ğ’†ªğ’…‚	*
MU	ğ’ˆ¬
MU2	ğ’Š¬
MUD	ğ’„·ğ’„­	*
MUD3	ğ’‰¯
MUDX	(LAK449)
MUG	ğ’ˆ®
MUL	ğ’€¯
MUN	ğ’µ
MUNSUB	ğ’ˆ°
MUNÅ UB	ğ’ˆ°
MUNU4	ğ’‰½ğ’Šºğ’‰½	*
MUNUS	ğ’Š©
MUR	ğ’„¯
MURGU	ğ’‹
MURGU2	ğ’ˆ±
MURU2	ğ’‰ 
MURU9	ğ’…ğ’‚‚	*
MURUB4	ğ’‰ 
MUSSA	ğ’Š©ğ’‘ğ’²	*
MUÅ 	ğ’ˆ²
MUÅ 2	ğ’ˆ½
MUÅ 3	ğ’ˆ¹
MUÅ EN	ğ’„·
MUÅ TUG2	ğ’ˆ¬ğ’‘ğ’Œ†ğ’‰¿	*
NA	ğ’ˆ¾
NA2	ğ’ˆ¿
NA4	ğ’
NAG	ğ’…˜
NAGA	ğ’‰€
NAGAR	ğ’‰„
NAGGA	ğ’€­ğ’ˆ¾	*
NAGGAX	ğ’€­
NAÄœ	ğ’…˜
NAÄœA	ğ’‰€
NAÄœA3	ğ’„¤
NAÄœA4	ğ’„£
NAM	ğ’‰†
NAM2	ğ’‰‡
NAMMA	ğ’‡‰
NANNA	ğ’‹€ğ’† 	*
NANÅ E	ğ’€
NAR	ğ’ˆœ
NE	ğ’‰ˆ
NE2	ğ’‰Œ
NI	ğ’‰Œ
NI2	ğ’‰
NI3	ğ’ƒ»
NI5	ğ’‰ˆ
NIDBA2	ğ’‰»ğ’ˆ¹	*
NIG	ğ’Š©ğ’Œ¨	*
NIG2	ğ’ƒ»
NIGA	ğ’Šº
NIGIN	ğ’‡”
NIGIN2	ğ’†¸
NIÄœ2	ğ’ƒ»
NIÄœIN2	ğ’†¸
NIM	ğ’‰
NIN	ğ’
NIN9	ğ’
NINA	ğ’€
NINDA	ğ’ƒ»
NINDA2	ğ’‰’
NINNA2	ğ’‡§
NINNI5	ğ’Œƒ
NIR	ğ’‰ª
NIR3	ğ’ğ’‰	*
NISAG	ğ’‰ 
NITA	ğ’‘
NITAá¸ª2	ğ’€´
NITALAM4	ğ’Š©ğ’‘	*
NU	ğ’‰¡
NU2	ğ’ˆ¿
NU11	ğ’‰¢
NU12	ğ’‡»
NUD	ğ’ˆ¿
NUM	ğ’‰
NUM2	ğ’ˆ
NUMUN	ğ’†°
NUMUN2	ğ’¤ğ’†¸	*
NUMUN3	ğ’„´
NUN	ğ’‰£
NUNDUM	ğ’…»
NUNUZ	ğ’‰­
PA	ğ’‰º
PA5	ğ’‰½ğ’‚Š	*
PAB	ğ’‰½
PAD	ğ’‰»
PAD3	ğ’…†ğ’Š’	*
PALIL	ğ’…†ğ’º	*
PAN	ğ’‰¼
PAP	ğ’‰½
PAR3	ğ’–
PE	ğ’„«
PEL	ğ’‰ˆ
PEL2	ğ’‰‹
PEÅ 2	ğ’‰¾
PEÅ 3	ğ’ˆ 
PEÅ 4	ğ’Š¯
PEÅ 6	ğ’†“
PEÅ 13	ğ’Š´
PI	ğ’‰¿
PI4	ğ’…—
PIL	ğ’‰ˆ
PIR2	ğ’•
PIRIG	ğ’ŠŠ
PIRIÄœ	ğ’ŠŠ
PIRIÄœ2	ğ’Œ“
PIRIÄœ3	ğ’ŠŒ
PISAÄœ	ğ’‚·
PISAÄœ3	ğ’‹„
PISAN3	ğ’Š¿
PU	ğ’
PU2	ğ’‡¥
PU3	ğ’…¤
QA	ğ’‹¡
QA2	ğ’‚µ
QAR	ğ’ƒ¼
QI2	ğ’† 
QI4	ğ’„„
QUM	ğ’„£
RA	ğ’Š
RA2	ğ’º
RAB	ğ’Š
RAK	ğ’Š©
RE	ğ’Š‘
RE2	ğ’Œ·
RE6	ğ’º
RE7	ğ’»
RI	ğ’Š‘
RI2	ğ’Œ·
RI8	ğ’ˆ¶
RIB	ğ’†—
RID	ğ’ˆ©
RIG2	ğ’®
RIM4	ğ’½
RIN	ğ’†¸
RU	ğ’Š’
RU6	ğ’‚”
RU12	ğ’‚—
SA	ğ’Š“
SA2	ğ’²
SA6	ğ’Š·
SA11	ğ’‹œ
SA12	ğ’Š•
SAG	ğ’Š•
SAG3	ğ’‰º
SAG9	ğ’Š·
SAGA11	ğ’†¥
SAGÅ U	ğ’Œ‹ğ’Š•	*
SAÄœ	ğ’Š•
SAÄœÅ U	ğ’Œ‹ğ’Š•	*
SAá¸ªARX	ğ’‰ˆ
SAL	ğ’Š©
SAL4	ğ’‹¡
SAMANX	ğ’‚ ğ’ğ’‚ ğ’‰£ğ’‚ ğ’Œ…	*
SANGA2	ğ’Š«
SAR	ğ’Š¬
SE2	ğ’£
SE3	ğ’‹§
SE12	ğ’…Š
SED	ğ’ˆ»
SI	ğ’‹›
SI2	ğ’£
SI11	ğ’‹
SI19	ğ’†‰
SI23	ğ’„¢
SIG	ğ’‹
SIG2	ğ’‹ 
SIG3	ğ’‰º
SIG4	ğ’‹
SIG7	ğ’…Š
SIG9	ğ’‹›
SIG10	ğ’‹§
SIG17	ğ’„€
SIK	ğ’‹
SIK2	ğ’‹ 
SIKI	ğ’‹ 
SIKIL	ğ’‚–
SIL7	ğ’‚£
SILA	ğ’‹»
SILA3	ğ’‹¡
SILA4	ğ’ƒ¢
SILIG	ğ’‚
SIM	ğ’‰†
SIMX	ğ’¼
SIMUG	ğ’Œ£
SIN2	ğ’‰†
SIPAD	ğ’‰ºğ’‡»	*
SIR2	ğ’
SIRARA	ğ’€
SIRARA2	ğ’Œ“ğ’ˆ£ğ’€ğ’‹“	*
SIRARA6	ğ’Œ“ğ’ˆ£ğ’€ğ’† ğ’‹³	*
SIRSIR	ğ’
SIS	ğ’‹€
SISKUR	ğ’€¬
SU	ğ’‹¢
SU3	ğ’‹¤
SU4	ğ’‹œ
SU6	ğ’…¾
SU7	ğ’‡­
SU11	ğ’…—
SU13	ğ’
SUB	ğ’…¢
SUB6	ğ’‹³
SUD	ğ’‹¤
SUD2	ğ’‹¥
SUD4	ğ’
SUEN	ğ’‚—ğ’ª	*
SUG	ğ’†¹
SUG4	ğ’‹¤
SUá¸ª3	ğ’„—
SUá¸ªUB3	ğ’‹—ğ’¹	*
SUá¸ªUB4	ğ’‹—ğ’²ğ’Œ	*
SUá¸ªUB5	ğ’‹—ğ’‚µ	*
SUá¸ªUBX	ğ’€¯ğ’‡	*
SUá¸ªUR	ğ’‹¦
SUá¸ªUÅ 	ğ’¼
SUKKAL	ğ’ˆ›
SUKUD	ğ’ƒ´
SUM	ğ’‹§
SUM2	ğ’®
SUMAÅ 	ğ’‹¨
SUMUNX	ğ’‚ 
SUMUR	ğ’Š¨
SUMUR2	ğ’‹¦
SUMUR3	ğ’ˆ°
SUN2	ğ’„¢
SUN5	ğ’”
SUN7	ğ’†—
SUR	ğ’‹©
SUR2	ğ’Š¨
SUR3	ğ’„®
SUR9	ğ’‹ª
SUR12	ğ’‡­
SURUNGAL	ğ’Œ“ğ’‰£	*
SUSBU2	ğ’ˆ½
SUSBU3	ğ’ˆ¹ğ’	*
SUÅ 2	ğ’‰Œ
Å A	ğ’Š­
Å A3	ğ’Š®
Å A4	ğ’º
Å A6	ğ’Š·
Å AB6	ğ’Š¸
Å ABRA	ğ’‰ºğ’€ 	*
Å AG4	ğ’Š®
Å AGAN	ğ’Œ‹ğ’ƒ¶	*
Å AÄœAN	ğ’Œ‹ğ’ƒ¶	*
Å AK	ğ’Š•
Å AKAN	ğ’Œ‹ğ’ƒ¶	*
Å AKIR	ğ’€
Å ALAMBI	ğ’Š®
Å AM2	ğ’‰›
Å AR	ğ’Š¬
Å AR2	ğ’Š¹
Å ARX	ğ’‰ˆ
Å ARA2	ğ’‡‹
Å E	ğ’Šº
Å E3	ğ’‚ 
Å E22	ğ’‚
Å EX	ğ’…Š
Å EX	ğ’€€ğ’…†	*
Å EG5	ğ’‹
Å EG9	ğ’Š¾
Å EG11	ğ’…
Å EGX	ğ’€
Å EÄœ3	ğ’€€ğ’€­	*
Å EÄœ6	ğ’‰ˆ
Å EM3	ğ’€š
Å EM5	ğ’€
Å EMBI	ğ’‹
Å EMBULUGX	ğ’‹
Å EN	ğ’Š¿
Å ENNU	ğ’‚—ğ’ˆ¨ğ’€œğ’†¬	*
Å ER7	ğ’‰ª
Å ER11	ğ’„Šğ’‡	*
Å EÅ 	ğ’‹€
Å EÅ 2	ğ’‹
Å EÅ 4	ğ’‚
Å EÅ LAM	ğ’‹‚
Å I	ğ’…†
Å ID	ğ’‹ƒ
Å IKA	ğ’†·
Å IM	ğ’‹†
Å IN	ğ’Š¿
Å INX	ğ’‹‹
Å INIG	ğ’‹’
Å IR	ğ’‹“
Å ITA	ğ’‹–
Å ITA3	ğ’‹¥
Å ITA4	ğ’Œ‹ğ’†¤	*
Å U	ğ’‹—
Å U2	ğ’‹™
Å U4	ğ’Œ‹
Å UB	ğ’Š’
Å UBA	ğ’ğ’ˆ½	*
Å UBTU6	ğ’†
Å UBTU7	ğ’†
Å UBTUM3	ğ’†œğ’†¸	*
Å UBUR	ğ’‹š
Å UDX	ğ’…—
Å UDU2	ğ’†ƒ
Å UDUL2	ğ’Œ‹ğ’Œ†	*
Å UDUM	ğ’‹ƒ
Å Uá¸ªUBX	ğ’‡ğ’€­	*
Å UK	ğ’‰»
Å UL	ğ’‚„
Å UM	ğ’‹³
Å UM2	ğ’‹§
Å UÅ 2	ğ’‹™
Å UÅ UR2	ğ’€½
Å UTUM	ğ’„€ğ’ˆ¾ğ’€Šğ’Œ‹ğ’„	*
á¹¢I2	ğ’£
TA	ğ’‹«
TAB	ğ’‹°
TAG	ğ’‹³
TAá¸ª	ğ’ˆ­
TAK4	ğ’‹º
TAL	ğ’Š‘
TAL2	ğ’‰¿
TAR	ğ’‹»
TAR2	ğ’¯
TE	ğ’‹¼
TE8	ğ’€‰
TER	ğ’Œ
TI	ğ’‹¾
TI2	ğ’—
TIBIR	ğ’‹³
TIDNIM	ğ’Š
TIDNUM	ğ’Š
TIGI2	ğ’ˆœğ’†	*
TIL	ğ’Œ€
TIR	ğ’Œ
TIRU	ğ’ƒ²ğ’‹¼	*
TU	ğ’Œ…
TU5	ğ’‹—ğ’‰€	*
TU11	ğ’„¸
TU15	ğ’…
TU17	ğ’€€ğ’‹—ğ’‰€	*
TUBAX	ğ’Œ†
TUD	ğ’Œ…
TUG	ğ’Œ‡
TUG2	ğ’Œ†
TUGX	(LAK483)
TUá¸ª	ğ’‚ƒ
TUK	ğ’Œ‡
TUKU	ğ’Œ‡
TUKU4	ğ’‡§
TUKU5	ğ’‹³
TUKUL	ğ’†ª
TUKUM	ğ’ˆœğ’†ğ’‹—ğ’ƒ»ğ’Œ‰ğ’‡²	*
TUKUR	ğ’†¸
TUKUR2	ğ’†
TUKUR3	ğ’†ˆ
TUM	ğ’Œˆ
TUM2	ğ’º
TUM3	ğ’‰
TUM9	ğ’…
TUM12	ğ’Œ…
TUMU	ğ’…
TUN3	ğ’‚…
TUR	ğ’Œ‰
TUR3	ğ’‰£ğ’‡¬	*
TUR8	ğ’
TUÅ 	ğ’†ª
TUÅ E	ğ’€€ğ’º	*
U	ğ’Œ‹
U2	ğ’Œ‘
U3	ğ’…‡
U4	ğ’Œ“
U5	ğ’„·ğ’‹›	*
U6	ğ’…†ğ’‚	*
U8	ğ’‡‡
U11	ğ’„·
U18	ğ’‡
U19	ğ’Œ·
UB	ğ’Œ’
UB2	ğ’‚ 
UBARA	ğ’‚¬
UBUR	ğ’›
UBUR2	ğ’¥
UBUR3	ğ’¡
UBUR4	ğ’¢
UD	ğ’Œ“
UD5	ğ’š
UDU	ğ’‡»
UDUB	ğ’‡›
UDUG	ğ’Œœ
UG	ğ’ŠŒ
UG5	ğ’‚¦
UGAX	ğ’Œ‘ğ’‰€	*
UGARX	ğ’…Š
UGNIM	ğ’† ğ’‹¢ğ’‡»ğ’‚ ğ’ƒ»	*
UGU	ğ’Œ‹ğ’…—	*
UGULA	ğ’‰º
UGUR2	ğ’…Š
UÄœ3	ğ’Œ¦
Uá¸ª	ğ’„´
Uá¸ª2	ğ’Œ”
Uá¸ª3	ğ’†µ
UKKIN	ğ’Œº
UKU3	ğ’Œ¦
UKUR3	ğ’‡³ğ’º	*
UL	ğ’ŒŒ
ULU3	ğ’‡
ULUÅ IN3	ğ’€¾ğ’€­	*
UM	ğ’Œ
UMAá¸ª	ğ’‡¦
UMBIN	ğ’Œ¢
UMBISAÄœ	ğ’‹ƒ
UMBISAÄœ2	ğ’‹„
UMMUX	ğ’‚”ğ’‡²ğ’€€	*
UMMUD	ğ’€€ğ’‚”ğ’‡²	*
UMUM	ğ’Œ£
UMUN2	ğ’Œ£
UMUN3	ğ’„´
UN	ğ’Œ¦
UN4	ğ’‚¬
UNKEN	ğ’Œº
UNU2	ğ’‹¼ğ’€•	*
UNU6	ğ’‹¼ğ’€Š	*
UNUG	ğ’€•
UQ	ğ’ŠŒ
UR	ğ’Œ¨
UR2	ğ’Œ«
UR3	ğ’ƒ¡
UR4	ğ’Œ´
UR5	ğ’„¯
UR11	ğ’€³
URI	ğ’Œµ
URI3	ğ’Œ¶
URI4	ğ’…‚
URIN	ğ’Œ¶
URU	ğ’Œ·
URU3	ğ’Œ¶
URU4	ğ’€³
URU5	ğ’‹½
URU17	ğ’‡
URUD	ğ’
URUDA	ğ’
URUDU	ğ’
US	ğ’Š»
US2	ğ’‘
USAGX	ğ’‰­ğ’€–ğ’†·		*
USAN2	ğ’„
USAN3	ğ’‰®
USANX	ğ’„™
UÅ 	ğ’‘
UÅ 2	ğ’—
UÅ 8	ğ’€³
UÅ 11	ğ’…œ
UÅ X	ğ’–
UÅ UMX	ğ’˜
UT	ğ’Œ“
UTTU	ğ’‹¸
UTUA	ğ’­
UTUA2	ğ’¦
UTUKI	ğ’™
UTUL5	ğ’Ÿ
UTUL10	ğ’€–ğ’‡»	*
UZ	ğ’Š»
UZ3	ğ’š
UZU	ğ’œ
UZUGX	ğ’…—ğ’Œ‘	*
WA	ğ’‰¿
WE	ğ’‰¿
WI	ğ’‰¿
ZA	ğ’
ZA3	ğ’ 
ZABALAM	ğ’ğ’ˆ½ğ’€•	*
ZABAR	ğ’Œ“ğ’…—ğ’‡	*
ZADIM	ğ’ˆ¯
ZAG	ğ’ 
ZAá¸ª	ğ’‰ˆ
ZAá¸ª3	ğ’€„
ZAK	ğ’ 
ZAL	ğ’‰Œ
ZALAG2	ğ’‚Ÿ
ZAMX	ğ’¡
ZAMUG	ğ’¾
ZAR	ğ’‡¡
ZAR2	ğ’‰Œ
ZE	ğ’£
ZE2	ğ’¢
ZI	ğ’£
ZI2	ğ’¢
ZI3	ğ’¥
ZI8	ğ’†—
ZIB	ğ’¦
ZIB2	ğ’¨
ZID	ğ’£
ZIG	ğ’¨
ZIG3	ğ’£
ZIK	ğ’¨
ZIL	ğ’‰£
ZIL2	ğ’‹³
ZIMBIR	ğ’Œ“ğ’„’ğ’‰£	*
ZIZ2	ğ’©
ZU	ğ’ª
ZU2	ğ’…—
ZU5	ğ’«
ZUB	ğ’‰½ğ’ˆ¿	*
ZUBI	ğ’‰½ğ’ˆ¿	*
ZUBUD	ğ’„ª
ZUBUR	ğ’­
ZUá¸ª	ğ’…—
ZULUMá¸ªI	ğ’‹ ğ’‹¤	*
ZUM	ğ’®
ZUR	ğ’€«

su2 	ğ’‹™ 
hu2 	ğ’€ª
BAN2 	ğ’‘‘ 
sa3 	ğ’¼  	ğ’— = ğ’ƒ» Å¡Ã¡ 
zu3	 ğ’®
bi3 	ğ’‘™
ha2 	ğ’€ª  	HAâ‚‚ ğ’€ª â‰ˆ ğ’—ğ’€ğ’¹ â‰ˆ ğ’„­ğ’€­ â€¢Hel ğ’„­ ğ’€­
as2 	ğ’€¾
gar2 	ğ’‹¼ğ’€€ 	ligature
is2  	ğ’„‘
mi3 	ğ’ˆ¨ 	me
sab 	ğ’‰ºğ’…  	ligature
se4 	ğ’¢
SIR3	ğ’‚¡ 
Å¡irâ‚ƒ	ğ’‚¡ 
Å¡ir3	ğ’‚¡ 
shir3	ğ’‚¡ 
GUB2 	ğ’†
GAB2 	ğ’†
dan6 	ğ’• 
eÅ¡8 	ğ’†œ
gagar 	ğ’† 
dag2 	ğ’Œ“
gagig 	ğ’ƒŸ  	"cry"
gurâ‚ƒ 	ğ’…
gur3 	ğ’…
guru3 	ğ’…
gaÄx 	ğ’…
gagx 	ğ’…
gaÄâ‚“ 	ğ’…
gagâ‚“ 	ğ’…
IL2 	ğ’…
ga6 	ğ’…
AG3 	ğ’‹ƒ
AGâ‚ƒ 	ğ’‹ƒ
AÄœ3 	ğ’‹ƒ
AÄœâ‚ƒ 	ğ’‹ƒ
gakkul	ğ’Œ‹ğ’µ 
gakkul2	ğ’Œ‹ğ’µ 
gakkulâ‚‚	ğ’Œ‹ğ’µ 
gakkul3	ğ’Œ‹ğ’´ 
gakkulâ‚ƒ	ğ’Œ‹ğ’´ 
gala10 	ğ’‡½ğ’¹
BALAÄœ 	ğ’†	
ÄœAL2 	ğ’…… 
kaÅ¡4 	ğ’½ 
kash4 	ğ’½ 
kas4 	ğ’½ 
SA10 	ğ’‰š 	NINDA2Ã—Å E  
imga 	ğ’…ğ’‚µ 	im-ga
GALLA 	ğ’‹¼ğ’‡²
GALLAx 	ğ’‹¼
GALLAâ‚“ 	ğ’‹¼
marku 	ğ’ˆ¥ğ’„©
gamarku 	ğ’‰Œğ’„©
gamar 	ğ’‰Œ
gambi 	ğ’Š©ğ’‘ğ’²
KE4 	ğ’²
KE4b	ğ’†¤
gam4 	ğ’ƒ¶
gam2 	ğ’„°
kur9 	ğ’†­ 
gamun 	ğ’·ğ’Œ 		cumin
gamun2 	ğ’Œ
gurâ‚â‚… 	ğ’Œ´
gur15 	ğ’Œ´
ganam4 	ğ’‡‡
ganam5 	ğ’‡†
gallagalx 	ğ’ƒ²ğ’‹¼ğ’‡²
gansis 	ğ’‹¯ 
ganzer 	ğ’…†ğ’†³ğ’  	#kanisurru "earth" 
ganzer3 	ğ’…†ğ’†³ 
garaÅ¡2 	ğ’† ğ’†˜ 		catastrophe
garaÅ¡5 	ğ’† ğ’†— 	garlic
garaÅ¡4 	ğ’†œğ’‚µ 	 garlic
banda 	ğ’Œ‰ğ’• 	ban3-da
TIL3 	ğ’‹¾ 
GAZâ‚‚  	ğ’„£ 	â‡” ğ’„¤ GAZ
GAZ2  	ğ’„£ 	â‡” ğ’„£ GUZ
kaz8 	ğ’€ª 
gazinbu 	ğ’  ğ’‚µğ’¥ğ’…”ğ’ ga-zi-in-bu
gidim2 	ğ’ˆ¦ğ’Œ‹ 	"ghost" â‰ˆ ğ’„‡  gidim
gidim3 	ğ’
dirig 	ğ’‹›ğ’€€
GIRâ‚â‚ 	ğ’†Ÿ 
GIR11 	ğ’†Ÿ 
gigir 	ğ’‡€  	# ğ’„‘ğ’‡¥ chariot ğ’‡€ â‰ˆ ğ’†¸ğ’ KURâ‚„baá¹­ â‰ˆ ğ“¡ ğ“„¿ ğ“ƒ€ ğ“² ğ“˜ ğ“‡‹ 
gigir2 	ğ’‡¥  	# ğ’„‘ğ’‡¥ chariot ğ’‡€ â‰ˆ ğ’†¸ğ’ KURâ‚„baá¹­ â‰ˆ ğ“¡ ğ“„¿ ğ“ƒ€ ğ“² ğ“˜ ğ“‡‹ 
girâ‚“  	ğ’ˆ²  	> ğ’ˆ² sÃ­r < ğ’ˆ² girâ‚“ â‰ˆ Kar (snake)
girx  	ğ’ˆ²  	
GEâ‚â‚„ 	ğ’Œ‹ 
ge3 	ğ’¹
GE14 	ğ’Œ‹ 
ge15 	ğ’€¸
ge22 	ğ’€º   
ge23 	ğ’€¹
ge24 	ğ’»
giguru 	ğ’Œ‹  	"edge"
giguru 	ğ’†‚ 	 giguru @ Gurgel "swallow"
giÄ4 	ğ’‚†
gar9  	ğ’‚µ
ga10  	ğ’‚µğ’‰Œ
gar11 	ğ’‚µğ’€€
gar12 	ğ’‚µğ’¹
garx  	ğ’‚µğ’‚µ
garaâ‚‚ 	ğ’‚¶ 	 âˆšgÃ¤hr cream 
gara2 	ğ’‚¶ 	 âˆšgÃ¤hr cream 
gar4  	ğ’„
GI16  	ğ’„ƒ  	"cross"
GE16  	ğ’„ƒ  	 ğ’„€ GI ğ’„ƒ GE "geometry" #qaÅ¡tu  
GIL   	ğ’„ƒ
gilil 	ğ’„ƒğ’…‹
gilim2 	ğ’‰¾ 
kilim 	ğ’‰¾ 
gibil3 	ğ’† ğ’‰ˆ
gibil2 	ğ’‹™ğ’€¾
bul5  	ğ’‡¡ 	  â€œplantâ€ <> ğ’†¸ â‰ˆ ğ“Šª in ğ’‡¥ PÃš "pool"
gideÅ¡ta 	ğ’ƒ»ğ’„•ğ’‹¡  	â‰ˆ ğ’ƒ»ğ’ƒ°ğ’‹¡  	â‰ˆ ğ’ƒ»ğ’‡¬ğ’‹¡ 
GIRâ‚… 	ğ’½  	
gigri2 	ğ’½ğ’½  	GIRâ‚…GIRâ‚… 
GUN4 	ğ’€• 		ğ“Œ¢
gir12 	ğ’…”  	Tier !
kilib 	ğ’†¸ 
nindan 	ğ’ƒ»
Äir3  	ğ’„Š
gir16 	ğ’„Œ 	ğ’€²  ğ’„Š GÃŒR
Äiri16 	ğ’„Œ
gir9  	ğ’€š 	   AB2Ã—Å A3  
gir7 	ğ’º
gir5 	ğ’½
gir14	ğ’„© 
girabax 	ğ’€Šğ’„«
gira 	ğ’Œ‹ğ’ˆ¦ğ’†
Å¡ukur 	ğ’†• 	 secret ğ’„€ğ’†• enclosure
gug6  	ğ’Š•ğ’†• 	seal  #kanÄku "to seal".
gug6  	ğ’Š•ğ’†• 	stick, weapon <>
GUG5  	ğ’ˆ™		 "Krieg" guerre
kin5  	ğ’Œº  URUÃ—BAR conâ€¦ port "gather" 
Å¡eg10 	ğ’†‚  	ğ’Š• SAG  â‰ˆ ğ’…— 
Å¡eg11 	ğ’…  	ğ’Š• SAG  â‰ˆ ğ’…— 
guana 	ğ’šğ’†œ 	guernica "battle"
gud2  	ğ’Š¥  	ğ’Š• SAG "â€¢chat" 
rah2  	ğ’Š  	ra
sumun2 	ğ’„¢
gudux 	ğ’„´
gudu4 	ğ’„´ğ’ˆ¨
gudug 	ğ’„´ğ’ˆ¨
gug   	ğ’ğ’„¢
gug4  	ğ’¤ğ’†¸ 
zi&zi  	ğ’¤
guhÅ¡u 	ğ’ˆğ’‹™
gukin  	ğ’‡  	å›½ guÃ³ ğ’†¥ KIN kingdom
gukin2 	ğ’„³ 
kin5  	ğ’Œº
gukkal 	ğ’„¾   ğŸ‘,ğŸ¥’,ğŸ˜
udugukkal 	ğ’‡»ğ’„¾   ğŸ‘
GU5 	ğ’†ª 
GUM2 	ğ’ˆ 	á¸ªUM LUM 
GUN5 	ğ’ˆ
MUR7 	ğ’ˆ± 
dim4 	ğ’‰½ğ’‰½
gun2 	ğ’„˜  	gu2 
nida 	ğ’„˜ğ’‰­
gunni 	ğ’† ğ’‰ˆ 	ki-ne
gunux 	ğ’‹œ
gurx 	 ğ’Šºğ’†¥  	Å E.KIN
GARADINX  	ğ’ƒ±
KINDA  	ğ’ƒ±  = ğ’€¶ğ’ƒ»Â²  GAD.GARÂ²
á¹£uqi 	ğ’‹»
suqi 	ğ’‹»
ssuqi 	ğ’‹»
par2 	ğ’Œ“ 	â‰ˆ pir ğ’• ğ’‘Šğ’‘–
nap 	ğ’†—  	ğ“Ÿğ“‹
zira 	ğ’‚”
zirai 	ğ’‚”
gurud 	ğ’ˆˆ  	ğ“€’
gurud2 	ğ’‰©ğ’†   	ğ“€’@ground
RINâ‚… 	ğ’ˆ• 
RIN5 	ğ’ˆ• 
gurum2 	ğ’…†ğ’‚Ÿ 
gurumâ‚“ 	ğ’…†ğ’ƒ»
gurumx 	ğ’…†ğ’ƒ»
guruÅ¡4 	ğ’‹³
guz 	ğ’ˆ
guza  	ğ’†ªğ’ƒ» 	kuáµˆgar
Äarar   	ğ’ƒ»ğ’…ˆ
rig7 	ğ’‰ºğ’„¸ğ’º  	PA.HUB2.DU
Äarim 	ğ’‡‘ 	  â‰ˆ garden "meadow"
kin2 	ğ’„¯
KÃN  	ğ’„¯
ÄœEÅ TIN	ğ’ƒ¾
ÄœESHTIN	ğ’ƒ¾
degâ‚“ 	ğ’Š‘
degx 	ğ’Š‘
mumu 	ğ’ˆ¬ğ’ˆ¬
par4 	ğ’‰Œ ğ’„‘
giparâ‚“ 	ğ’†¦
giparx 	ğ’†¦
ÄœIR15 	ğ’‚ 
Äiri2 	ğ’„ˆ
ME2  	ğ’ˆª
ÄuÅ¡ur 	ğ’ƒ¡ 	 	 guÅ¡Å«ru "beam"
ÄuÅ¡ur2  	ğ’Šğ’ƒ²
ÄuÅ¡urâ‚“  	ğ’Šğ’Œ‰ğ’Œ‰
ÄuÅ¡urx  	ğ’Šğ’ˆ¤
guÅ¡ur2  	ğ’Šğ’ƒ²
guÅ¡urâ‚“  	ğ’Šğ’Œ‰ğ’Œ‰
guÅ¡urx  	ğ’Šğ’ˆ¤
gushurx  	ğ’Šğ’ˆ¤
Äiparx 	ğ’†¦
Äiparâ‚“ 	ğ’†¦
giparx 	ğ’†¦
giparâ‚“ 	ğ’†¦
geÅ¡pu2 	ğ’‹—ğ’‰½ğ’‰½
geÅ¡paâ‚“ 	ğ’‹—ğ’‰½ğ’‰½
geÅ¡baâ‚“ 	ğ’‹—ğ’‰½ğ’‰½ğ’€
geÅ¡bax 	ğ’‹—ğ’‰½ğ’‰½ğ’€ 	"Geboxe"
PAâ‚“ 	ğ’‰½ğ’‰½
bulug3 	ğ’‰½ğ’‰½
PAx 	ğ’‰½ğ’‰½
BUâ‚â‚€ 	ğ’‰½ğ’‰½ 	bowl
BU10 	ğ’‰½ğ’‰½ 	bowl
geÅ¡tu2 	ğ’„‘ğ’Œ†ğ’‰¿ 	gis-tu2-pi cuneiform GIÅ .TUGâ‚‚.PI	ÄeÅ¡tug2 geÅ¡tug2 ÄeÅ¡tu2
si3 	ğ’…†
i4 	ğ’Œ
kiÅ¡ig2 	ğ’„‰
buru5 	ğ’‰…  	bird / locust
buru4 	ğ’‰¢ğ’“  	bird of prey ( ğ’“ BUR )
buru15 	ğ’‰¢ğ’…•  	bird of prey
azlag2 	ğ’Œ†
azad 	ğ’€€ğ’‡‰ğ’‹™
azad2 	ğ’‹º 
GURâ‚â‚†  	ğ’†³  	 áŒ‹áˆ« gara áƒ’áƒáƒ áƒ gÃ³ra à²—à²¿à²°à²¿ ĞºĞ°Ğ¹Ğ° Ú©Û„Û ×”Ö·×¨ ğ’†´ ğ’†³*ğ’†³ kur-kur-ra 
GUR16  	ğ’†³  	 áŒ‹áˆ« gara áƒ’áƒáƒ áƒ gÃ³ra à²—à²¿à²°à²¿ ĞºĞ°Ğ¹Ğ° Ú©Û„Û ×”Ö·×¨ ğ’†´ ğ’†³*ğ’†³ kur-kur-ra 
buruâ‚ˆ  	ğ’„¬ 	 buruË¢ pars buruâ„¢ part
buru8  	ğ’„¬ 	 buruË¢ pars buruâ„¢ part
burâ‚ˆ  	ğ’„¬ 	 buruË¢ pars buruâ„¢ part
bur8  	ğ’„¬ 	 buruË¢ pars buruâ„¢ part
buluch  	ğ’„¬
bur'ux  	ğ’¬ 	 ğ’„­ ğ’Œ‹ â‰ˆ ğ’‡¥ PÃš ğ“Šª ğ’„° ğ’„­ğ’ baÅ™
buru16 	ğ’‡¡ 	bul5 â€œplantâ€ <> "pool" ğ’†¸ â‰ˆ ğ’‡¥ â‰ˆ ğ“Šª 
kit2 	ğ’†¤
buru6 	ğ’†¤ğ’„· 	bird ğ’†¤ğ’„· GIE ğ’„€ğ’‚Š gi-e â‰ˆ ğ’„–ğ’Œ« gu-ur2 "crow" 
BUâ‚‡ 	ğ’†ª  
BU7  	ğ’†ª 	 "bright, light"
burur2 	ğ’“ğ’Œ« 	 bur.ur2 bearer (libation-)priest 
bur11 	ğ’† ğ’‚—ğ’†•  	<> port
muru6 	ğ’† ğ’‚—ğ’†• 	  <> muer Mauer
burx 	ğ’†ƒ  	break ğ’†ƒ	KAÃ—Å U
burâ‚ˆ  ğ’‰½ 	 Ğ¿Ğ°Ñ… pax â‰ˆ pap ğ’‰½ cross â‰ˆ ğ’‰½ crotch 
bur8  ğ’‰½ 	 Ğ¿Ğ°Ñ… pax â‰ˆ pap ğ’‰½ cross â‰ˆ ğ’‰½ crotch 
kunin 	ğ’‡’
buniÄ 	ğ’†¹ 
buniÄ2 	ğ’‡… 
buniÄ3 	ğ’‡‰ 
bunin 	ğ’†¹ 
bunin2 	ğ’‡… 
bunin3 	ğ’‡‰ 
bunga 	ğ’‘ğ’‚µ 	Bengel
buluh 	ğ’„¬ 	 burâ‚ˆ buruâ‚ˆ peur fear Furcht 
KUÅ U2	ğ’†µ
buluÄ 	ğ’‘ 	 â‰ˆ bulun Î²ÎµÎ»ÏŒÎ½Î· belÃ³nÄ“ "needle" <> Î²Î­Î»Î¿Ï‚ (bÃ©los, â€œarrow, dartâ€)
bul3 	ğ’„ 	bal
buluÄ3 	ğ’‰½ğ’‰½ 
bulug3 	ğ’‰½ğ’‰½ 
buluÄâ‚ƒ 	ğ’‰½ğ’‰½ 
bulugâ‚ƒ 	ğ’‰½ğ’‰½ 
bulug5 	ğ’† 	balag 	â‰ˆ ğ’Œ£â€¢ğ’™ 	Balg ğ“…¡ ğ“¡ ğ“€€
buluÄ5 	ğ’† 	balag 	â‰ˆ ğ’Œ£â€¢ğ’™ 	
bu4 	ğ’€€
bul 	ğ’‡§  	"blow"
bul4 	ğ’…® 	KAÃ—IM  ğ’…—ğ’… bul4; bul; bulâ‚„ "blow"
bulâ‚„ 	ğ’…® 	KAÃ—IM  ğ’…—ğ’… bul4; bul; bulâ‚„ "blow"
bun2 	ğ’…®
bÃº 	ğ’†œ 
bu2 	ğ’†œ 
biz 	ğ’‰
biz2 	ğ’„ 
bisag 	ğ’‚· 	 "basket" ğ’‚·ğ’‹ƒ GÃ.rib ğ’„€ğ’‚· Korb 
bisag2 	ğ’‹ƒ 	 "basket"
bisag3 	ğ’‹„ 	 "basket"
bisaÄ 	ğ’‚· 	 "basket" ğ’‚·ğ’‹ƒ GÃ.rib ğ’„€ğ’‚· Korb 
bisaÄ2 	ğ’‹ƒ 	 "basket"
bisaÄ3 	ğ’‹„ 	 "basket"
bisan 	ğ’‚· 	 "basket" ğ’‚·ğ’‹ƒ GÃ.rib ğ’„€ğ’‚· Korb 
bisan2 	ğ’‹ƒ 	 "basket"
bisan3 	ğ’‹„ 	 "basket"

bur5 	ğ’„·ğ’Šºğ’‚Ÿ á¸ªÅª.Å E.sigâ‚…/sagâ‚â‚€ Heuschrecke 
lu8 	ğ’Œ· 	áµ›lu8  ville ğ’Œ· #alu â‰ˆ ğ’Œ¨ á¸ªUL 

da10 	ğ’„­ 	â‰ˆ ğ’Œ“ DAG2 day 

LU5 	ğ’ˆœ LUB lupo welpe wolf
LUâ‚… 	ğ’ˆœ LIK Î»ÏÎºÎ¿Ï‚ lÃºkos  

biluda 	ğ’‰ºğ’€­

bir7 	ğ’Š®	 break "shred"  <> ğ’„­ â‰ˆ ğ’Œ“ BIR2 
bir6 	ğ’Š°	 break "shred"  
bir9 	ğ’Š³	 break "shred"  
bir9b	ğ’Šµ	 break "shred" 
bir9 	ğ’‰‹ 	BIRâ‚‰ break "shred"
bir9 	ğ’‰‹ 	BIRâ‚‰ burn 
bar7 	ğ’‰‹ 	BARâ‚‡/NE burn brazier 

bir9 	ğ’‰‹ 	BIRâ‚‰ burn 
bar7 	ğ’‰‹ 	BARâ‚‡/NE burn brazier 
bIL 	ğ’‰ˆ
bÃ­L 	ğ’‰‹  
bil2 	ğ’‰‹ 
bil3 	ğ’„‘ğ’‰‹ 
bed3	ğ’†ª 	 "piss" (vulgar)  
be5	ğ’†ª  	 "piss" (vulgar)  
bid3	ğ’†ª 	 "piss" (vulgar)  

be4 	ğ’€ 	baË¢  base "to deduct, remove; to diminish, reduce" â‰ˆ 
be6 	ğ’‰¿ 	pi   base "to deduct, remove; to diminish, reduce" â‰ˆ 

bibad 	ğ’Šºğ’„·ğ’Œ‰ğ’„·  	"a bird"
bazbaz 	ğ’Šºğ’„·ğ’„· 	 ba-ba-za bibad.muÅ¡en

bara6	ğ’‡™	  bright brown? ğ’‡ƒ me.en ğ’ˆ¨ğ’‚— "a color term"

bara2 	ğ’ˆ
barag 	ğ’ˆ
bara6	ğ’‡™	  barag parakku ğ“†¤ "regent"
bara7	ğ’‡‹ 	 barag parakku ğ“†¤ "regent"
bara8	ğ’‡£ 	 barag parakku ğ“†¤ "regent"
bara10 	ğ’ƒ–	= ğ’ˆ BARA2 = ğ’ƒ– baraâ‚â‚€ FÃ¼hrer #barag 

bara9	ğ’‡—	 = ğ’ˆ barag porch â‰ˆ pouch bag Bauch 


si8 	ğ’² 	â‰ˆ ğ’‹› SI	ğ’‹ SIK Ïƒ sigma "square" in ğ’€ğ’‹› = ğ’€ğ’² base

wu	ğ’‰¿
w 	ğ’‰¿

DUL5	ğ’Œ† 	<> dog, TÃ¶le
banÅ¡ur2	Â¿â‰ˆğ’â‰ˆğ’†“?
banÅ¡ur3 	ğ’†“
barim 	ğ’‡ğ’½
barim2 	ğ’‰ºğ’½	 PA.RIM barim barren prairie
barim3 	ğ’€ğ’½

TAB2 	ğ’„‰ 
Å¡ed10 	ğ’ˆ¹ğ’² 	sedate, settle, cool down

Å¡a2 	ğ’ƒ» 	â‰ˆğ’‹© 
du5 	ğ’‚…  	dun

bappir 	ğ’‹‡ 
bappir2 	ğ’‹† 
bappir3 	ğ’‹	   ğ’‰Â·ğ’ƒ» â‰ˆ ğ’‹   BIÃ—GAR @ ğ’‰ beer

barag2 	ğ’– 	barack ğ’–  dak 	ğ’–  	Dach
babarag2 	ğ’€ğ’– 	âˆšpart : ?spread out?

bara4 	ğ’ 	âˆšpart : ?spread out?
barr  	ğ’ 	âˆšpart : ?spread out?
bar3  	ğ’ 	âˆšpart : ?spread out?
baÅ™   	ğ’

nir2 	ğ’ğ’‚†  	<> ğ’‰Œğ’Œ“ na4 nÅ«r

bad4 	ğ’† ğ’†—
bad5 	ğ’…†ğ’…† 	beat, defeat #dabtu

ba7 	ğ’ˆ¦  	#bÄmtu part: half #miÅ¡lu
ba3 	ğ’Œ  	#bÄmtu part: "half; thirty" Akk. ; Å¡alÄÅ¡Ä

ya10 	ğ’€€ 	A ğ’…€ ya yo ğ’„¿ yi I

min5 	ğ’€ 	â‰ˆ ğ’ˆ« ğ’– ğ’¹ğ’¹ ğ’‘– ğ’‹° ğ’€¸ğ’€¸ ğ’€ ğ’€¹ğ’€¹ ğ’‘Š ğ’ƒµ ğ’‘² ğ’Œ‹ğ’Œ‹ ğ’™ ğ’‘± ğ’Œ€ ğ’‹» ğ’‡ ğ’ ğ’— ğ’‘˜ ğ’‘™  

BAá¸ªARâ‚‚ 	ğ’ƒ	 â‰ˆ ğ’‚” BAá¸ªARâ‚‚ potter ğ’‡ğ’‚” baá¸«arâ‚ƒ ğ’Œ‹ğ’‚” baá¸«arâ‚„ "potter" po'er (British)
BAá¸ªAR2 	ğ’ƒ	
baá¸«arâ‚ƒ 	ğ’‡ğ’‚” 
baá¸«ar3 	ğ’‡ğ’‚” 
baá¸«arâ‚„ 	ğ’Œ‹ğ’‚” 
baá¸«ar4 	ğ’Œ‹ğ’‚” 

BAhARâ‚‚ 	ğ’ƒ	 â‰ˆ ğ’‚” BAá¸ªARâ‚‚ potter ğ’‡ğ’‚” baá¸«arâ‚ƒ ğ’Œ‹ğ’‚” baá¸«arâ‚„ "potter" po'er (British)
BAhAR2 	ğ’ƒ	
baharâ‚ƒ 	ğ’‡ğ’‚” 
bahar3 	ğ’‡ğ’‚” 
baharâ‚„ 	ğ’Œ‹ğ’‚” 
bahar4 	ğ’Œ‹ğ’‚” 
bahar 	ğ’„

LAK742 	Â¿â‰ˆğ’ƒ?
LAK747 	Â¿â‰ˆğ’ƒ?

pe2 	ğ’‰¿

balak 	ğ’„ 	×¤Ö¶Ö¼×œÖ¶×š pÃ©lekh Akk. pilaqqu "spindle" ++
bala  	ğ’„ 	bal <> Ball Ballen "spindle" Akk. pilaqqu < Ğ²ĞµÑ€ĞµÑ‚ĞµĞ½Ğ¾ <> ë°©ì¶” 
sar2 	ğ’ƒ»
balla 	ğ’ƒ» ğ’Š•ğ’‚µğ’‚… ğ’‚¡ğ’‚· 	  "wig" Å¡ar sag.ga.TUN Å¡irâ‚ƒ.ga2 #zikari ; upur sinniÅ¡ti; upur zikari
balla2 	ğ’ƒ»ğ’Š•ğ’‚µğ’‚…ğ’‚¡ğ’Š© 		 	"wig" Å¡ar sag.ga.TUN Å¡irâ‚ƒ.ga2 #zikari ; upur sinniÅ¡ti; upur zikari

BANDA3	ğ’Œ‰
BAN3.da	ğ’Œ‰ğ’• 	=
BANDA4 	ğ’…‚   	  Bund puntal puntello bÄng "support, stanchion": pole, post
BANDA5 	ğ’‹ğ’…‚ 	Bund puntal puntello bÄng "support, stanchion": pole, post

baneÅ¡ 	ğ’€¾ 	 baÃ±o? (a container)

banÅ¡ur  	ğ’ 
banÅ¡urâ‚“ 	ğ’‚  	bench !
banÅ¡urx 	ğ’‚ 	URUÃ—IGI 
banÅ¡urâ‚“ 	ğ’‚ 	URUÃ—IGI 

bakirum 	ğ’Œ‹ğ’Š¬ 	"a carrying strap" Akk. hiÅ¡um Å¡a nukaribbi

bal3 	ğ’€¡ 	  ğ’€  bull â‰ˆ ğ’€¡ balâ‚ƒ ğ’€¦ balâ‚„ buddel @ Beil
bal4 	ğ’€¦ 	  ğ’€  bull â‰ˆ ğ’€¡ balâ‚ƒ ğ’€¦ balâ‚„ buddel @ Beil

du10 	ğ’„­
du14 	ğ’ˆŒ  ğ’‡½ â€¢don â‰ˆ ğ’†•ğ’‰ˆ DU3:
du17 	ğ’‰ˆ
dim3  	ğ’ˆš  	don, demon
ddim3 	ğ’ˆš  	ğ’ˆšğ’ˆ¨	áµˆdim3-me demon (deity)



deg5 	Â¿
dara2 	ğ’… 

durah 	ğ’° DARA3	
durahâ‚“ 	ğ’± 	DARA4	
durahx 	ğ’± 	DARA4	


dun5  	ğ’˜ 
du9  	ğ’˜ 

dupsik 	ğ’‚µğ’‚… ga.TUN "basket"
dusu 	ğ’‚µğ’‚… ga.TUN "basket"

da9 	ğ’Œ¤	 	stir
dim6 	ğ’Œ¤	 â‰ˆ ğ’Œ£ â‰ˆ ğ’†
dimx 	ğ’†
dimma 	ğ’†ğ’ˆ  	dumme? LÃ¤mmer  takmÄ«su
dim12 	ğ’‹ƒ
dilib 	ğ’‹ƒ 	
dilib2 	ğ’†‚
dilib3 	ğ’Š 
dilib4 	ğ’Š
dilib5 	ğ’Š¦
dilib6 	ğ’ŠŸ
di5 	ğ’Š‘  	â€¢diarrhea Durchfall "bowel disorder"

# ğ’‡½ LÃš â‰ˆ ğ’€  al in 
dubal 	ğ’€¥
dubal2 	ğ’€¦
dubal4 	ğ’ˆ† 
dubal6 	ğ’ˆˆ
dubal7 	ğ’ˆ

dih3 	ğ’†¨ 	turmoil

daÄal 	ğ’‚¼ 	GÃ Ã— AN  

dab2 	ğ’‹°  	tab
dab4 	ğ’¾ 	dub

eb 	ğ’…

dilurx 	ğ’ˆ£ğ’†• 	 ğ’‹› sail in  ğ’ˆ£ğ’ˆ® "mast" (â‰ˆ MUG mace)  
dilur 	ğ’ˆ£ğ’ˆ® 	 ğ’‹› sail in  ğ’ˆ£ğ’†• #áµakÃ» â‰ˆ ğ’ˆ£ğ’†• kak/khurn
si12 	ğ’…Š 
diri 	ğ’‹›ğ’€€
du26 	ğ’‹›ğ’€€



dalhamun  	ğ’…ğ’‹–   	ğ’Š‘ğ’„©ğ’µ dal-ha-mun ğ’… 
dalhamun4 	ğ’…‘ 
dalhamun5 	ğ’€°  
dalhamun6 	ğ’… 
dalhamun7 	ğ’‰ƒ
hamun     	ğ’‰ƒ

dida 	ğ’‰ğ’Œ‘ğ’Š“ 
didax 	ğ’Œ‘ğ’Š“
dubad 	ğ’† ğ’†—

dubul 	ğ’‹—ğ’
dulu 	ğ’‹—ğ’
dabx 	ğ’‡†
daban 	ğ’‹°ğ’‹°ğ’‘– 	â‰ˆ ğ’€® â‰ˆ ğ’€Š  
dabin 	 ğ’¥ğ’Šº 	ZI3.Å E
dagan 	ğ’† ğ’‡
daggan 	ğ’† ğ’‡
giÅ¡gal 	ğ’‡
gisgal 	ğ’‡
dalx 	ğ’„·
dala2 	ğ’…†ğ’†•	
dalla2 	ğ’…†ğ’‰Œ 	IGI.NI

danna 	ğ’†œğ’
dana2 	ğ’†œ

daparu 	ğ’‡½ğ’ˆ¨ğ’‚— 	depart/defeat 

dara5 	ğ’„’ 	Traube
dehi 	ğ’¾  	tax
tehi 	ğ’¾  	tax
dib2 	ğ’†ª 	< ğ’³ dib Dieb, transfer, pass

didalx 	ğ’‰ˆ
digbir 	ğ’† ğ’‰ˆğ’€­ğ’ˆ¹

me8 	ğ’‰¿  		me ğ’ˆ¨
il5 	ğ’‚– 	 	fille 

dilim3 	ğ’‡Œ 	 ğ’†¸ğ’… lagab(dil).im

dimna 	ğ’Œ‹ğ’‚µ
dur9 	ğ’‚„
Å¡ahâ‚‚ 	ğ’‚„ 	 Sau
Å¡ah2 	ğ’‚„ 	 Sau
cis 	ğ’„‘
dimuÅ¡ 	ğ’Œ‘ğ’„‘ğ’ˆª
dudux 	ğ’‰ºğ’œ	(|PA.UZU|) beating <> tÃ¶ten?
tud2  	ğ’‰ºğ’œ 	thrashing
dul9  	ğ’Œª 	TÃ¶le ğ’Œ¨
dul2 	 ğ’‡¥ 	dull deep(en)

saÄÄa 	ğ’‹ƒ
dungu 	ğ’…ğ’‹›ğ’€€  	 "cloud" <> ğ“ ğ“ˆ– ğ“Œ° ğ“…“ ğ“…± ğ“‡° dunkel

duri 	ğ’‰¢
durme 	ğ’Š•ğ’‚¡

durunax 	ğ’†ªğ’†ª 	tannour (oven)

dusu2 	ğ’€²ğ’…†ğ’‚  	Dussel > Esel donkey
dusux 	ğ’€²ğ’…†ğ’³ 	Dussel > Esel donkey

ul3  	ğ’„’ 	â‰ˆ ğ’†œ ville

e5 	ğ’
e6 	?
e7 	ğ’…—
e11 	ğ’‡¯ğ’º

ebih2 	ğ’‚ ğ’ˆ¤
epir 	ğ’‚
ebir 	ğ’‚
ebir2 	ğ’‰ 	 BIÊ³ beer
epir2 	ğ’‰ 	 BIÊ³ beer
epirx 	ğ’‹† 
ebirx 	ğ’‹† 
ebir3 	ğ’€€
epir3 	ğ’€€
ebir4 	ğ’‚µ
ebla 	ğ’€€ğ’‹»ğ’€€ğ’€­

dezim 	ğ’Šºğ’Šºğ’‰ª  	cereals #aÅ¡nan
dezim2 	ğ’Šºğ’Šºğ’‰ª  	cereals #aÅ¡nan
ezina2 	ğ’Šºğ’Šºğ’Šºğ’‰ª  	cereals #aÅ¡nan

ezix 	ğ’Š©ğ’‡¬
muhaldim 	ğ’ˆ¬ 	MUË¡ 
edakua  	ğ’ƒ‘
edakua2  	ğ’†º 	
ezem 	ğ’‚¡ 	ezen
eurre 	ğ’‚ğ’† ğ’‹§ğ’‚µ 	grave áµeurrev Ã©-ki.Å¡um.ga
sakar 	ğ’Š¬

eg2 	ğ’‚Š 	â‰ˆ
iku2 	ğ’‚½ 

ba9 	ğ’

egir2 	ğ’‚  	 â‰ˆ 
gi7   	ğ’‚  	 â‰ˆ 
egir3 	ğ’Š©ğ’‚  	 â‰ˆ ğ’
egi2  	ğ’Š©ğ’‚  	 â‰ˆ ğ’
egi3  	ğ’† ğ’Š•

etutum  	ğ’‚¿ 	 	 ğ“¡ ğ“¡ ğ“‡° eÅ£Ã»tu ğ’‹¯ old reading <> ğ’‹« TA â˜‘ <> ğ’Œ– itima tenebre  
eÅ¡Å¡eb 	ğ’† ğ’… 	"a deeply incised landscape" Akk. huddudu
eÅ¡lug 	ğ’ˆŠ	LU2Ã—LAGAB "offspring" 

eÅ¡kiri  	ğ’Œ‹ğ’‚™
eÅ¡giri  	ğ’Œ‹ğ’‚™
eÅ¡kiri2  	ğ’„‘ğ’‚™
eÅ¡giri2 	ğ’„‘ğ’‚™
kiri3 	ğ’…—
giri17 	ğ’…—

eÅ¡gal 	ğ’€  	earth

eÅ¡emen  	ğ’† ğ’‚Šğ’‰ˆğ’² ki.eáµne gammon "game"
eÅ¡emen2 	ğ’† ğ’‚Šğ’‰ˆğ’²ğ’€­ğ’ˆ¹
eÅ¡emen3  	ğ’‚ ğ’„¾ eÅ¡â€¦
eÅ¡emen5 	ğ’‰  	a'gamen
eÅ¡en    	ğ’‚Šğ’Š¿ a game


á¸ªUL2  	ğ’„¾ 	  â‰ˆ ğ’„· á¸ªU :
BIBRA 	ğ’„¾ 		piper bird 
BIBRI 	ğ’„¾ 		piper bird 
KUÅ 8  	ğ’„¾ 	KUÅ â‚ˆ, UKUÅ â‚‚ â‰ˆ ğ’Š» áµus < ğ’„· á¸ªU
UKUÅ 2 	ğ’„¾ 	KUÅ â‚ˆ, UKUÅ â‚‚ â‰ˆ ğ’Š» áµus < ğ’„· á¸ªU

EÅ 2 	ğ’‚ 
eÅ¡e2 	ğ’‚   	Ecke (area) <> acre
eÅ¡e3 	ğ’…‚  	Ecke (area) <> acre
eÅ¡ela 	ğ’ˆ€ğ’‡²  	 ğ’‚ ğ’‡½ğ’‡² á¶ EÅ â‚‚LUâ‚‚ Fessel á¶ eÅ¡ela
LUâ‚‚Ã—EÅ â‚‚ 	ğ’ˆ€

eÅ¡dam 	Â¿
eÅ¡a  	ğ’€€ğ’Œ 	A.TIR

Å¡ed6 	ğ’†ª 	âˆšsit "lavatory" Akk. bÄ«t Å¡itti
eÅ¡10 	ğ’€€

eÅ¡22 	ğ’‡´
eÅ¡x 	ğ’‡´

eÅ¡13 	ğ’‰‰ 	   NEÃ—A  áµeÅ¡13 kuÅŸÅŸÃ» "cold, winter"

essad	 ğ’ ğ’„© 	Flosseâ„¢ @ fish
eÅ¡sadu	 ğ’€Šğ’„©ğ’ ğ’ƒ®ğ’„· 	Flosseâ„¢ @ fish / bird
essadu	 ğ’€Šğ’„©ğ’ ğ’ƒ®ğ’„· 	Flosseâ„¢ @ fish / bird

ehehhe 	ğ’†ªğ’†ªğ’†ª 	cripple â‰ˆ ku-tripple 

kid3 	ğ’€  	aká¶¥áµˆ 
etutum  	ğ’‚¿ 	 ğ“¡ ğ“¡ ğ“‡° eÅ£Ã»tu ğ’‹¯ <> ğ’Œ– itima tenebre
etutumx 	ğ’‚¿ 	 ğ“¡ ğ“¡ ğ“‡° eÅ£Ã»tu ğ’‹¯ <> ğ’Œ– itima tenebre

esir  	ğ’€€ğ’‡’
esir2 	ğ’‡’ â‰ˆ
esir2b 	 ğ’‡‰
esirâ‚‚ 	 ğ’‡‰
esirhia 	ğ’‡“
esir3 	ğ’†“ğ’†“

lagabxhal 	ğ’‡‰ 	lagabÂ·hal ;)

esaÄ2    	ğ’ƒ¥
esag2    	ğ’ƒ¥
esaÄ    	ğ’ƒ¥ 	Å EÃ—GAâ‚‚ GAâ‚‚Ã—Å E granary
esaÄtur 	ğ’ƒ¦ 	Å EÃ—GAâ‚‚+TUR GAâ‚‚Ã—Å E+TUR "grain-store" 

esaÄ 	ğ’€ˆ 	 â‰ˆ
esag 	ğ’€ˆ 	|AÃ—SAG| â‰ˆ
asag 	ğ’†¬ğ’€­ 		"heir"

eriÅ¡tix 	ğ’ƒ²ğ’ª 	#erÅ¡u "wise" ?
erin9 	ğ’Œ¯
erim7 	ğ’Œ¯ 	army
eren8 	ğ’Œ¯
UR2Ã—á¸ªA 	ğ’Œ¯	

erim5 	ğ’€•  	"(store)room" =
erim3 	ğ’Œ¿ 		URUÃ—GAR
erim6 	ğ’  	URUÃ—UD
erim4 	ğ’ƒ«  	GA2Ã—UD guard

eridu 	ğ’‰£  	irÄ«tu "guidance"
erida2 	ğ’‰ºğ’Š· 	|PA.Å Aâ‚†| "courtyard sweeper" Akk. kisalluhhu
eribura	ğ’‰« 	NUN%NUN "bird droppings"
erib	ğ’€¿ 	AÅ GAB	

ereÅ¡ 	ğ’  	first lady â‰ˆ ğ’® dame ğ’‚–	EL el
ereÅ¡ 	ğ’Š©ğ’Œ† â‰ˆ ğ’® dame ğ’‚–	EL el
ereÅ¡ 	ğ’Š©ğ’Œ†  SAL.TUGâ‚‚ ğ’ ğ’ ğ’Šª


ereÅ¡  	ğ’ƒ²ğ’€­ğ’ª
ereÅ¡5 	ğ’ƒ²ğ’€­ğ’ª 	 |GAL.AN.ZU|  aristoâ€¦ ğ“‹ á¼„ÏÎ¹ÏƒÏ„Î¿Ï‚ "wise"
eriÅ¡tiâ‚“	ğ’ƒ²ğ’ª  	ğ’‚Šğ’Š‘ğ’…–ğ’‹¾ e-ri-iÅ¡-ti ğ’‚Šğ’Š‘ğ’…–ğ’Œˆ #erÅ¡u "wise" aristoâ€¦ ğ“‹ á¼„ÏÎ¹ÏƒÏ„Î¿Ï‚ 

ensi3 	ğ’‚š
ensix 	ğ’‰ºğ’‹¼ğ’‹›ğ’ƒ» 	PA.TE.SI.GAR
ensiâ‚“ 	ğ’ƒ»ğ’‰ºğ’‹¼ğ’‹› 	GAR.PA.TE.SI

ereÅ¡4 	ğ’€³ earth worker

erx 	ğ’ºğ’º
er3 	ğ’€´ 	ARAD

kinkin 	ğ’„¯ 	Eâ‚‚.|HIÃ—AÅ â‚‚|	e2-kinkin (e2-kikken)
kikken 	ğ’„¯ 	Eâ‚‚.|HIÃ—AÅ â‚‚|	e2-kinkin (e2-kikken)
kinkin2 	ğ’„¯ğ’„¯	 Eâ‚‚.|HIÃ—AÅ â‚‚.HIÃ—AÅ â‚‚|	e2-kinkin2 (e2-kikken2)
kikken2 	ğ’„¯ğ’„¯	 Eâ‚‚.|HIÃ—AÅ â‚‚.HIÃ—AÅ â‚‚|	e2-kinkin2 (e2-kikken2)

kiÅ¡ib 	ğ’ˆ© 	â‰ˆ kitab
kiÅ¡ib3 	ğ’¾ 	â‰ˆ kitab

kurun2 	ğ’·

ellag 	ğ’†¸ 	
ellag2 	ğ’„µ
ellaÄ2 	ğ’„µ
ellaÄx 	ğ’„¶

er13 	ğ’ˆ 		LU2Ã—EÅ 2 tenÃ»   ir13  
era3 	ğ’ƒ 	FÃ¼hrer |GAâ‚‚Ã—ME+EN|	gammon

ellamkuÅ¡ 	  ğ’‡Œ 	LAGABÃ—IM "animal bladder" Akk. ellabbuhhu
ellamkuÅ¡2 	ğ’‡– 	LAGABÃ—LU "animal bladder" Akk. ellabbuhhu
ellamkuÅ¡3 	ğ’‡ˆ 	LAGABÃ—HA "animal bladder" Akk. ellabbuhhu
ellamkuÅ¡4 	ğ’†¹ 	LAGABÃ—A	 "animal bladder" Akk. ellabbuhhu

lungax 	ğ’‹ 	BIÃ—GAR
BIÃ—GAR 	ğ’‹
BIxGAR 	ğ’‹

ru10 	ğ’‹½
uru5 	ğ’‹½

eme 	ğ’…´
eme1 	ğ’˜
eme2 	ğ’Œğ’ˆ¨ 	|UM.ME| Amme "wet nurse" Akk. muÅ¡Ä“niqtu
emeda 	ğ’Œğ’ˆ¨ 	Amme, mother
ummeda 	ğ’Œğ’ˆ¨ 	Amme, mother
emedada 	ğ’Œğ’ˆ¨ğ’• 	Amme, mother
ummedada 	ğ’Œğ’ˆ¨ğ’• 	Amme, mother
emeda3  	ğ’Œ 	Amme, mother
emeda3  	ğ’ŒŸ 	Amme, mother
emeda3  	ğ’˜ğ’• 	Amme, mother
emeda   	ğ’Œ¼ğ’ˆ¨ğ’• 	Amme, mother


eme3  	ğ’Š©ğ’€² 	SAL.ANÅ E	imÄ“rum á¸¥imÄr â€œdonkeyâ€
eme6  	ğ’€²ğ’Š© 	ANÅ E.SAL	imÄ“rum á¸¥imÄr â€œdonkeyâ€
eme5  	ğ’Š©ğ’„¸ 	SAL.HUBâ‚‚	imÄ“rum á¸¥imÄr â€œdonkeyâ€
eme7  	ğ’Š©ğ’€  	SAL.AL	imÄ“rum á¸¥imÄr â€œdonkeyâ€
emex  	ğ’Š©ğ’‚— 	SAL.EN	imÄ“rum á¸¥imÄr â€œdonkeyâ€


emedub 	ğ’ƒ†  	GAâ‚‚Ã—DUB
emedub2 	ğ’ƒ§  	GAâ‚‚Ã—Å ID

emeÄarx 	ğ’…¶  		KAÃ—ME+GI "magic" â‰ˆ (|KAx(ME.GAR)|) 
# ğ’…¶	KAÃ—ME+GI "magic" â‰ˆ emeÄarâ‚“ |KAÃ—(ME.GAR)|
# ğ’…´ğ’ƒ» KAÃ—ME+GAR â‰ˆ ğ’‚Šğ’ˆ¨ğ’ƒ» e-me-Äar emeÄarâ‚“ "Magier"

emerah  	 ğ’Š©ğ’„¸ 		|SAL.HUBâ‚‚|	
emerahx 	ğ’Œ“ğ’Š©ğ’„¸ 	UD.SAL.HUBâ‚‚

emeÅ¡ 	ğ’Š©ğ’‡¬  	(|SAL+LAGAR|) "priest"
emezi 	ğ’Š©ğ’‡¬  	(|SAL+LAGAR|) "priest"

emeÅ¡ 	ğ’‚ğ’Œ 	 SUMMER ğ’‚ğ’ˆ¨ğ’Œ e2-me-eÅ¡; ğ’‰Š Akk. ummu
emeÅ¡2 	ğ’‰Š
eÅ¡12 	ğ’‰Š

en2 	ğ’‹™ğ’€­ 	 |Å Uâ‚‚.AN|	song "incantation, spell" Akk. Å¡iptuË¡ 7

enaqa 	ğ’‰Œğ’Œ“ğ’… 	Akk. ennakku

endib 	ğ’‚—ğ’ˆ¨ğ’ˆ¬ 	"cook" Akk. nuhatimmu
engiz 	ğ’‚—ğ’ˆ¨ğ’„€ 	"temple cook" Akk. engiÅŸu; engÃ»; nuhatimmu

en7 	ğ’ 
enku 	ğ’ ğ’„©  	|ZAG.HA|	
enkud 	ğ’ ğ’„©

enkum 	ğ’‚—ğ’‰½ğ’…Šğ’‰£ğ’ˆ¨ğ’‚¬ 	"temple treasurer" Akk. enkummu

enna 	ğ’ğ’‚— 	NA.EN 	ğ’‰Œğ’Œ“ğ’‚—  ennakku

ennigi 	ğ’‚—ğ’‰­ğ’¶
ennigi2 	ğ’‚—ğ’‰­ğ’¶  "a priest" Akk. ennigÃ» EN.NUNUZ.DIMâ‚‚|	 	


nuÄx 	ğ’‰£ 	NUN â‰ˆ NUNG =: nuÄ

uÄ5  	ğ’‚¦
un3 	ğ’‚¦ 	â‰ˆ ğ’‚© DUN â‰ˆ dome

enten 	ğ’‰‰  	|NEÃ—A|	

epig 	ğ’‹  	pug(SIG) "a drinking vessel" Akk. maÅ¡qÃ»

hab2  	ğ’‡¥
hab   	ğ’†¸

# Akk. hurru > hole â‰ˆ Kuhle
habruda 	ğ’†¢ 	KIÃ—U|	
habruda2 	ğ’†¡ 	KIÃ—BAD|	
habruda3 	ğ’Š° 	Å Aâ‚ƒÃ—BAD|	
habruda4 	ğ’Šµ 	Å Aâ‚ƒÃ—U|	

henzer 	ğ’…†ğ’´ 	|IGI.DIM|	"to block" Akk. pehÃ» fecht fight
henzir 	ğ’…†ğ’´ 	|IGI.DIM|	"to block" Akk. pehÃ» fecht fight
bu3 	ğ’„· 	á¸ªU bird

haÅ¡hur 	ğ’ˆ¢  	MA@gunu

hulum 	ğ’Š™  	SAGÃ—HA?
hulumx 	ğ’Š™  	SAGÃ—HA|
hulum2 	ğ’Šœ  		SAGÃ—LUM|
hulum3	ğ’  	 DAG.KISIMâ‚…Ã—HA

hirim 	ğ’† ğ’†—  	"?; waste land; ditch" Akk. ittÃ»; miÅ£ru; pitru

hubhub  	ğ’‹„ 	"tube"
hubhub  	ğ’‹„ 	|Å IDÃ—A|	 huphuppu "a container".
hubhub2 	ğ’‹… 	Å IDÃ—IM

# halba [BUCKET] (1x: Old Babylonian) wr. halba; halba5 

lal2 	ğ’‡³

halba 	ğ’ˆºğ’² 	|MUÅ â‚ƒÃ—A+DI| "a bucket for a well" Akk. kannu Å¡a burti
halba5 	ğ’‡³ğ’‡ 	|LALâ‚‚.URUÃ—MIN|	


hul 	ğ’„’  	 hull? "ring; rein" Akk. hullu
hul3 	ğ’„’
ul3 	ğ’„’

hud4 	ğ’Š·  	Å Aâ‚†	 "bronze arrowhead" Akk. hutpu Å¡a2 siparri

huduÅ¡ 	ğ’Œ…  	"a social status, bridegroom?" Akk. huduÅ¡Å¡u

dul6 	ğ’‡¯ 	 LAGAR@gunu

# halba [FROST] "frost, ice, cold weather; (to be) cold" Akk. halpÃ»; kuÅŸÅŸÃ»; mammÃ»; takÅŸÃ¢tu; Å¡urÄ«pu
halba2 	ğ’ğ’ˆ¹ğ’² 	ZA.MUÅ â‚ƒ.DI
halba6 	ğ’€€ğ’ˆ¹ğ’² 	A.MUÅ â‚ƒ.DI
halba 	ğ’ˆºğ’² 	MUÅ â‚ƒÃ—A+DI|
halpi 	ğ’‡³ğ’‡ 	LALâ‚‚.URUÃ—MIN|


heÅ¡5 	ğ’ˆ‚ 	hÃ¤scher "detain" |LUâ‚‚Ã—GANâ‚‚@t|.EÅ â‚‚
haÅ¡  ğ’‹» 	 	hÃ¤scher "detain" ğ’‹» â‰ˆ ğ’‘Šğ’¹
haÅ¡3 	ğ’Œ“ 	 < kiÅ¡Å¡Ätu debt-slavery

hara3 	ğ’ˆŠ  	guzallu "ruffian, scoundrel"; ishappu "villain, rogue".

hursaÄ  	ğ’‰º ğ’‚… 	âˆšhair:barber
hamanzer 	ğ’‰ºğ’… 	âˆšhair:combed

hibira 	ğ’€¤ 	heir firstborn
hibiz2 	ğ’€¤ 	heir firstborn

hibiz 	ğ’Œ‰ğ’¹ 	#ruÅ¡Å¡Ã» red (â€¢hibiskus)

hilib2 	ğ’‰€ 	âˆšlieb libido "liebenswÃ¼rdig" NAGA leibigâ‰ˆpleasure <>  hili kar[love]
bu6 	ğ’‡¥
ub4 	ğ’‡¥

halib 	ğ’…†ğ’†³ 	hell! Halbwelt "Netherworld" Akk. irkala

halubba 	ğ’ƒ‘
GAâ‚‚Ã—HA+LU+EÅ â‚‚ 	ğ’ƒ‘
GA2Ã—HA LU EÅ 2 	ğ’ƒ‘

harub 	Â¿ 	carob(tree)

tibir 	tag
tibir2 	ğ’‹·
tibirâ‚„ 	ğ’‹¸  

henburx 	ğ’…†ğ’†•
teÄ3 	ğ’‹¼

hirin2 	ğ’€Š
hurin 	ğ’ˆ¾ğ’Š’

hubud 	ğ’„Šğ’‹—ğ’……

hux 	ğ’†ª

hulpad 	ğ’…†ğ’Œ¨ğ’Š’ğ’ƒ»

rum 	 ğ’€¸
rumum 	ğ’€¸ğ’Œ

huru 	ğ’„¯

huÅ¡2 	ğ’„Š

ibila 	ğ’Œ‰ ğ’‘ 	Erbe
ibila2 	ğ’Œ‰ğ’€´ 	Erbe

ibbi  	ğ’…
ibbi2 	ğ’‰ˆ
ibbix 	ğ’‰ˆ

ibira2 	ğ’…›
ibira 	ğ’…ª 		<> offer
tibira2 	ğ’…ª 		KAÃ—GIÅ Ã—GIÅ  <> cash

tag4 	ğ’‹º 	TAKâ‚„ â‰ˆ ğ’‡¯ DU6

i7  	ğ’€€ğ’‡‰ 		|A.LAGABÃ—HAL|	id2 
i8  	ğ’‡‰   	|LAGABÃ—HAL|	id3 
id2 	ğ’€€ğ’‡‰ 		|A.LAGABÃ—HAL|	
id3  	ğ’‡‰   	|LAGABÃ—HAL|	 
id6 	ğ’€€ğ’‡‰ğ’ƒ²	|A.LAGABÃ—HAL.GAL|	
id7 	ğ’€€ğ’‡‰ğ’²	|A.LAGABÃ—HAL.DI|	
id5 	ğ’€€	

ge4 	ğ’„„ 	geâ‚„ ğ’„€ GI@gunu 

igi3 	ğ’† ğ’Š•

lib4 	ğ’…† 	alive, awake

saÄ5 	ğ’‰  	 	search, sort NISAG #nasÄqu

huz 	ğ’ˆ

zu7 	ğ’‚„

izi2 	ğ’† ğ’‰ˆ

dutu 	ğ’Œ“

itudx 	ğ’Œ“ğ’€­ğ’‹€ğ’† 
iti6  	ğ’Œ“ğ’€­ğ’‹€ğ’† 

ud@s 	ğ’Œš 	ğ’Œ“ ud

iti 	ğ’Œ—
itid 	ğ’Œ—
itud 	ğ’Œ—

itima2 	ğ’Œ– 	"darkness" Akk. eÅ£Ã»tu
utima2 	ğ’Œ– 	"darkness" Akk. eÅ£Ã»tu

illar 	ğ’Š’  	â‰ˆ
iÅ¡kila 	ğ’Š¯ 	âˆškuller "pebble" <> skull (rund)

iÅ¡dumx 	ğ’¼

isiÅ¡3 	ğ’€…

isim3 	ğ’Œ‹ğ’€œ 	 riqÅ« "aromatic substance" <> riech ğ’‹† RIK RIQ : ğ’‹† Å¡imáµƒË¡ : smell, aroma

isim2 	ğ’„¢
isimu2 	ğ’„¢
isimu3 	ğ’Œ‹ğ’€œ
isim3 	ğ’Œ‹ğ’€œ

isinx 	ğ’Šºğ’…†ğ’Œ‰


ir7 	ğ’†œ 	â‰ˆ ğ’…• ir â‰ˆ ğ’‹† RIK RIQ Riech ereÅ¡u "smell, scent"

ri6 	ğ’º

uru2 	ğ’ 	store-area

iri8  	ğ’…‚	iri8pad ğ’ #rapÄdu

iri11 	ğ’€•  	â‰ˆ URU
eri11 	ğ’€•
uru11 	ğ’Œ¾
iriki 	ğ’Œ·ğ’† 

igira2  	ğ’† ğ’Š•ğ’Š© 	egret > heron
igirax  	ğ’† ğ’…—ğ’Š© 	egret > heron

i6  	ğ’Œ† 	è¡£ yÄ« yÇ Tuch
i5 	ğ’…—

ia4 	ğ’

ildag 	ğ’„‘ğ’‹¥ 	GIÅ .SUDâ‚‚ 	
ildag2 	ğ’„‘ğ’„Ÿ 	GIÅ .GUDÃ—A+KUR 	
ildag2 	ğ’„Ÿ  	GUDÃ—A+KUR 	
ildag4 	ğ’„‘ğ’ƒ¿ 	GIÅ .TINÃ—KUR 	
ildag3 	ğ’„‘ğ’„  	GIÅ .GUDÃ—KUR 	
ildagx 	ğ’„‘ 	 	GIÅ  	

# ğ’„Ÿ ğ’„‘ğ’„Ÿ ğ’„‘ğ’ƒ¿ ğ’„‘ğ’„  ğ’„‘ğ’‹¥ ğ’„‘ ildag ildakku Ñ‚Ğ¸Ñ€ĞµĞº tirek adÄru "poplar tree"

ildum 	ğ’…†ğ’‚ ğ’ºğ’‚Ÿ
ildum2 	ğ’…†ğ’‰„ğ’
ildu 	ğ’…†ğ’‚ ğ’ºğ’‚Ÿ
ildu2 	ğ’…†ğ’‰„ğ’

illu 	ğ’€€ğ’†— 	a.kal aquaË¡ !
ilu 	ğ’€­  	Allah

sahar 	ğ’…–

inbir 	ğ’ˆ“  !war! ippÄ«ru

inda2 	ğ’†¹ğ’‹»

eg3 	ğ’‰˜

e6 	Â¿
elles316 	Â¿
hara5 	Â¿
arhuÅ¡5 	ğ’€‰ğ’Œ‰ 
arhuÅ¡6 	ğ’€‰ğ’Š©
Å¡em3 	ğ’€š

Å¡ir2 	Â¿
kup5 	Â¿
egirâ‚„ 	ğ’Œˆ 
egir4 	ğ’Œˆ 
is4 	ğ’„‘

taka4 	ğ’‹º
tug3 	ğ’‰¿ğ’Œ† 	pi.tug2
ul4 	ğ’„‰
zug2 	ğ’…— 	ğ’Š• saÄ
zugâ‚‚ 	ğ’…— 	ğ’Š• saÄ

Äa3 	ğ’‚·Â·ğ’ˆ 		ğ’‚·â€¢ğ’…• Äa2.ir 
Äanun 	ğ’ƒ  	ğ’‚·Â·ğ’‰£ GÃÃ—NUN GAâ‚‚.NUN	Äa2.nun Kontor
Äeli3 	ğ’…² 	Kehle
tu2 	ğ’Œ†
Äisal  	ğ’„ğ’„‘ 	â‰ˆ ğ’‰ğ’„‘ BI.GIÅ  ğ’„€ğ’Š“ğ’€  gi-sa-al ğ’„€ğ’Š­ğ’€ ğ’ˆ gi-Å¡a-al-lum ğ’ˆ¬ğ’Š­ğ’ˆ  mu-Å¡a-lum <> sail
bir2 	ğ’Œ“
sha2 	ğ’‹š  	sau

inna 	ğ’± 	DARAâ‚„ "fleece"

ir9 	ğ’„Š 	GIRâ‚ƒ great, ir'abu

irhandi 	Â¿  	ÄÅ¡ipu "sorcerer, magician; incantation priest, exorcist".

irib2 	ğ’‡—

irigal  	ğ’€ 	irrigated earth erÅŸetu
urigal  	ğ’€ 	irrigated earth erÅŸetu
urugalâ‚‚ 	ğ’€•  	 ğ’Œ·ğ’ƒ²     -''-
urugal2 	ğ’€•  	 ğ’Œ·ğ’ƒ²     -''-

pag 	ğ’„· 

kab2  	ğ’…˜  	ğ’…—.ğ’€€ ka.ab
kabx  	ğ’Š–  	ğ’…—.ğ’€€ ka.ab


kur4 	ğ’†¸

kurx 	ğ’º 	enter karib
kurx 	ğ’‡¸ 	enter 'lil aller

DAG.KISIMâ‚…  	ğ’–ğ’†¨
DAG.KISIM5  	ğ’–ğ’†¨

kiÅ¡i15 	ğ’†œğ’„´ 	ant
kiÅ¡i13	ğ’„´ğ’†œ
kiÅ¡i8 	ğ’ 		DAG.KISIMâ‚…Ã—GIRâ‚‚|	
kiÅ¡i7 	ğ’  	DAG.KISIMâ‚…Ã—GI|
kiÅ¡i9 	ğ’¬  	DAG.KISIMâ‚…Ã—Uâ‚‚+GIRâ‚‚|
kiÅ¡i6 	ğ’Š¾ 	  Å EGâ‚‰

KISIMâ‚…	ğ’†¨ 	cheese
KISIM5 	ğ’†¨	
kisim 	ğ’¬
kisim3 	ğ’¦ 	 |DAG.KISIMâ‚…Ã—LU+MAÅ â‚‚|	
kisim7 	ğ’›   |DAG.KISIMâ‚…Ã—GA|

kisim2 	ğ’ª  	Gestall "animal stall" Akk. tarbaÅŸu |DAG.KISIMâ‚…Ã—SI|	


kiÅ¡i11 	ğ’…ƒ	IDIM&IDIM.BUR "the Netherworld" Akk. kurnugi kar necro

kiÅ¡i12 	ğ’‰£ğ’Šº 	â€˜cacheâ€™ "secret" Akk. piriÅ¡tu

kiÅ¡ib2 	ğ’‰¾ 	hamster?
kiÅ¡i5 	ğ’‰¾ 	acacia â‰ˆ
kiÅ¡i10 	ğ’Œ‹ğ’ŠŠ

sag@n 	ğ’Š”
kiÅ¡i4 	ğ’Š” 	â‰ˆ ğ’…— ka
kiÅ¡ix 	ğ’† ğ’Š”
kissa 	ğ’† ğ’‹€ğ’†•
kislah2 	ğ’†£
kislah3 	ğ’† ğ’†—

kid2 	ğ’‹º 	â€˜cutâ€™ "to break off, pinch off" Akk. karÄÅŸu TAKâ‚„
kid7 	ğ’… 	KID2IM ^^
kid4 	ğ’‹ƒ  	> Å ID

karaâ‚“ 	ğ’†’  	KAD4
karaâ‚“ 	ğ’†“  	KAD5
kukku3 	ğ’† ğ’† 

ku10 	ğ’ˆª  	kaka=dark
kukku5 	ğ’ˆª  	kaka=dark
kukku2 	ğ’ˆªğ’ˆª  	kaka=dark-place eklÄ“tu

kakkala 	ğ’€Š
kuruÅ¡da 	ğ’€Š
kurun3   	ğ’‚ 	DUG "good"

kurum6 	ğ’‰»  	"food ration" kurummatu

dil  	ğ’€¸ 	 Teil [[ğ’€]] DIDLI  ğ’€ TÃ¼ttel â‰ˆ ğ’Œ€ â‹ ğ’‹¾ TIL tilâ‚ƒ  â‰ˆ [[dash]] ğ’¹ DIÅ  â‡” ğ’€¸ aÅ¡ â‡” ğ’— uÅ¡  

kir5 	ğ’…‚
sigx 	ğ’Š¬ 

kunga 	ğ’‹™ğ’€¯
kunga2 	ğ’‹™ğ’€­ |Å Uâ‚‚.AN|

kun2 	ğ’‰º  	(shine)bright

kibÅ¡ur 	ğ’ƒ»ğ’†¸  	"very plentiful" Akk. Å£uhhudu

kum2 	ğ’‰ˆ 	
kum4 	ğ’Œ“ 	charm:warm

kuksu2 	ğ’†•ğ’‹» 	Egge? ğ’†• KAK
kuksu 	ğ’‹»

kuÄx 	ğ’ˆ
kuÄ5 	ğ’Œ‰ğ’‚  	 	 ÏƒÎºÎ¬Î»Î± skÃ¡la scale (stair) (Äâ‰ˆnâ‰ˆlâ‰ˆr -- )
kuÄ5 	ğ’Œ‰ğ’‚   	<>  grade (stair)
kun5 	ğ’Œ‰ğ’‚   	<> á€á¶áŸ†á‡ááŸ’áŠá¾áš kam cÅ­É™ndaÉ™ Õ¡Õ½Õ¿Õ«Õ³Õ¡Õ¶Õ¶Õ¥Ö€ astiÄanner
kun4 	ğ’„¿ğ’‡»  	<> ÎºÎ»Î¯Î¼Î±ÎºÎ± klÃ­ma
kuÄ4 	ğ’„¿ğ’‡»  	ê³„ë‹¨ gyedan

kul2 	ğ’„¢  	gul

ulutim2 	ğ’† ğ’…Šğ’€© 	ultima Urheimat

Å¡ur2 	ğ’Š¨
peÅ¡5 	ğ’†’

kirix 	ğ’…®
kirid 	ğ’†Ÿ
kir11 	ğ’Š©ğ’ƒ¢ 	capre ğ’‹¡ğ’Š‘;ğ’‹¡ğ’Š‘ğ’Š‘	kari; qa-ri; qa-ri-ri	"lamb" 
kiraÅ¡i 	ğ’€¾ğ’€€ğ’€­ 	Gersten Bier  ğ’† ğ’Šğ’…† Gerste "emmer"

kir3  	ğ’†¸
kilib  	ğ’†¸
kilib3  	ğ’†¸ğ’†¸

kinbur 	ğ’†¼ Kinder-burrow "nest"  ğ’†¹ğ’‡² ğ’†¸ğ’€€ğ’‡²

mu11  	ğ’…¿

kankal 	ğ’† ğ’†—

kinx  	ğ’Šºğ’†¥

dur5  	ğ’€€

ka6  	ğ’„·

kib  	ğ’„’  	ğ€ğ€¡ ka-po ÎºÎ±ÏÏ€ÏŒÏ‚ karpÃ³s ğ“‚§ ğ“„¿ ğ“ƒ€ â€¢cheirbe "grape"

kazaza  	ğ’„®  	"a destructive insect" Akk. kazazakku

sig15  	ğ’†—

Å¡akan3  	ğ’€²

karkidx  	ğ’Š©ğ’‘

kulx  	ğ’„ 	ball â‰ˆ KUL ğ’†°  

su8  	ğ’»

kad6 	ğ’¦  	gather â‰ˆ ğ’†’ KADâ‚„ ğ’†“ KADâ‚…
KAD8  	ğ’€½ 	gather â‰ˆ ğ’¦

kadra 	ğ’ƒ»ğ’Š®ğ’€€ 	cadeau "gift" kadrÃ» Å£Ätu Torte
kag2  	ğ’…— 	ka

silim  	ğ’²  	salam

kaÄeÅ¡karax  	ğ’„‘ğ’…—ğ’†’  	GIÅ .KA.KAD4 #kannaÅ¡karakku "a table"
kageÅ¡karax  	ğ’„‘ğ’…—ğ’†“  	GIÅ .KA.KAD5 #kannaÅ¡karakku "a table"

pana 	ğ’‰¼
kaku 	ğ’½  	circle courir "run"


gala3 	ğ’‡¥ 	LAGABÃ—U
gala4 	ğ’†½ 	LAGABÃ—AL	
kala4 	ğ’†½ 	LAGABÃ—AL
gala5 	ğ’‡ 	LAGABÃ—KI
kala3 	ğ’‡¥ 	LAGABÃ—U
ki-la2	ğ’† ğ’‡² 	KI.LAL

kam3 	ğ’†’

kama5 	ğ’ˆƒ	 	|LUâ‚‚Ã—HIÃ—BAD|

mu7 	ğ’…²  	Mund?
mu13 	ğ’†€


kana6 	ğ’…¤ 	áƒ£áƒ™áƒ£áƒœáƒ˜ uá¸³uni "dark" KAÃ—GANâ‚‚
kana5 	ğ’…¸ 	KAÃ—MI	ğ“† chemie "dark"
kana3 	ğ’Š 		SAGÃ—MI â‰ˆ schwarz
kana6 	ğ’…¤ 	ĞºÑŠĞ°Ñ€Ğ°Ğ½Ğ³Ñ‹ qaraÃ±Ä± ĞºĞ°Ñ€Ğ°Ğ½ÑŠĞ° karaÃ±a ĞºĞ°Ñ€Ğ°Ò£Ğ³Ñ‹ karaÅ‹gÄ± <> krank 

ku2 	ğ’…¥ 	KAÃ—GAR krank?

karam 	ğ’ƒ« ga.rağ“‡³ 	â‰ˆ cairn  "heap, ruin mound" Akk. karmu

karaÅ¡ 	ğ’† ğ’†˜  	âˆšguerre "military camp" Akk. karÄÅ¡u

lu7 	ğ’‡

lipiÅ¡ 	ğ’€š  	Leib , love:rage



GIÅ %GIÅ  	ğ’„’  	ğ’†œ kas GIÅ  [[ğ’„‘]] ğ’„•
NUN%NUN 	ğ’‰«
UR%UR 	ğ’Œ©	
URÃ—UR 	ğ’Œ©	
ğ’†™	KALÃ—KAL
ğ’†œ	KASKAL
lirum 	ğ’‹—ğ’†— 	Å U.KAL
lirum3 	ğ’„’ GIÅ %GIÅ 
lirum7 	ğ’†™ 	KAL%KAL
lirum6 	ğ’‰« 	NUN%NUN
lirum8 	ğ’Œ© 	UR%UR
lirum2 	ğ’€¸ 	AÅ 	
liru2 	ğ’€¸ 	AÅ 	

mumun 	ğ’…²ğ’…²
lunga2 	ğ’‹‡
ge5 	ğ’† 
lah6 	ğ’º
hara4 	ğ’š
nir7 	ğ’ğ’‚‡
Å¡umunda 	ğ’‡°ğ’Š¬
aÅ¡@z 	ğ’€¹
bu%bu 	ğ’
ha@t@g 	ğ’„ª	 	â‰ˆ ğ’†¦ğ’„ª	 ğ’„«
garadin3 	ğ’Š½	 	ğ’Šºğ’Šºğ’‹°ğ’‹°ğ’ƒ»ğ’ƒ»


### AUTO:
la6 	ğ’†—
laban 	ğ’‚¯
la7 	ğ’Œ“
lahtan4 	ğ’‰µ
lahtan3 	ğ’‰¹
lamhu 	ğ’†´
lib5 	ğ’Š¤
libin 	ğ’‚±
lidda 	ğ’‹–
lil8 	ğ’ˆ‘
lillan 	ğ’ˆ—
lu9 	ğ’‰º
lu6 	ğ’Œ¨
lubun 	ğ’‚²
lud 	ğ’‚
lugud2 	ğ’†¸
luÄ2 	ğ’‰º
lum3 	ğ’‚
lumha 	ğ’†
GIâ‚„ 	ğ’€€
EÅ â‚‚ 	ğ’‡
Å Aâ‚† 	ğ’‡
GIRâ‚‚@g 	ğ’„‰
dinig3 	ğ’ˆŠ
DUBâ‚‚ 	ğ’„­
giguru3 	ğ’†‚
girim 	ğ’†¸
giriÅ¡ 	ğ’„µ
gi4-X 	ğ’€€
gur14 	ğ’…—
gur13 	ğ’‰Œ
gurdub 	ğ’ƒ
BURâ‚‚ 	ğ’€
HA@g 	ğ’„«
ha-X 	ğ’„©
i-a 	ğ’…€
ILâ‚‚ 	ğ’…†
GANâ‚‚@t 	ğ’…†
MUÅ â‚ƒ@g 	ğ’…†
immal2 	ğ’‰¦
immen 	ğ’†‰
immen2 	ğ’…˜
immindu 	ğ’‡Œ
immindu2 	ğ’‡…
kaÅ¡2 	ğ’†œ
kaÅ¡3 	ğ’’
gir8 	ğ’†¸
kuÅ¡7 	ğ’…–
kuÅ¡um2 	ğ’ˆœ
mah2 	ğ’€ 
mahra 	ğ’ˆ¾
makkaÅ¡2 	ğ’€¸
mangaga 	ğ’…¾
mangara 	ğ’‘
me7 	ğ’ƒ™
ma6 	ğ’ˆ¨
mel 	ğ’…–
meli2 	ğ’…²
menari 	ğ’ƒ»
mezem? 	ğ’‹„
min6 	ğ’‹°
minbulug 	ğ’
mu5 	ğ’‰Œ
mu6 	ğ’‰º
mud2 	ğ’
mud5 	ğ’‹†
mud6 	ğ’Š¬
mudla 	ğ’
mug2 	ğ’Š©
muh3 	ğ’Š£
mul2 	ğ’‹¼
mul3 	ğ’„®
mul4 	ğ’ŒŒ
mun4 	ğ’‹€
murgu3 	ğ’…º
murum 	ğ’…—
muru3 	ğ’…
murub6 	ğ’Œ™
muÅ¡Å¡agana 	ğ’‡š
muÅ¡taptin 	ğ’ƒ
ne3 	ğ’ŠŠ
nesaÄ2 	ğ’‹ƒ
GIRâ‚‚ 	ğ’‰
ninim 	ğ’Š²
nisig 	ğ’Š¬
nisku 	ğ’ŠŠ
niÅ¡ 	ğ’™
nita2 	ğ’€´
nu7 	ğ’€•
nug 	ğ’‹
nug2 	ğ’‹Š
nun3 	ğ’
pa9 	ğ’‡
pirig2 	ğ’Œ“
pirig3 	ğ’ŠŒ
TUL2 	ğ’‡¥
puzur5 	ğ’…¤
puzur2 	ğ’™
ra3 	ğ’Œ“
raba 	ğ’Š
rag 	ğ’Š©
ra-ah 	ğ’€€
raÅ¡u 	ğ’†³
ru-gu2 	ğ’ƒ®
sa9 	ğ’ˆ¦
sabad2 	ğ’‚¿
sabad3 	ğ’ƒ–
sad2 	ğ’ƒª
sad3 	ğ’‚¿
sa2-di 	ğ’Š­
sag8 	ğ’†—
sag10 	ğ’…†
sag12 	ğ’…Š
sag7 	ğ’ƒ¶
sagkurini 	ğ’„­
sagkurun 	ğ’¸
saÄ4 	ğ’ˆ—
KEÅ â‚‚ 	ğ’Š•
saÄdu 	NA
saÄÄar2 	ğ’…—
saÄ-ki 	ğ’…†
saÄtak 	ğ’€¸
santak3 	ğ’€¹
saÄtak4 	ğ’¹
santak2 	ğ’»
saguÅ¡ 	ğ’…—
sah 	ğ’†¤
sah4 	ğ’„—
sahar2 	ğ’Š¬
sal3 	ğ’‰Œ
sal2 	ğ’²
salugub 	ğ’€¸
sam2 	ğ’‰š
samag3 	ğ’Œ¡
samag6 	ğ’…Š
sas 	ğ’‹€
se11 	ğ’‹Ÿ
se28 	ğ’…†
sed4 	ğ’‡
Å¡e11 	ğ’ˆœ
ses 	ğ’‹€
si14 	ğ’‚
sidug 	ğ’‡‚
sidug2 	ğ’‡„
siki2 	ğ’Œ“
Å¡ikin2 	ğ’‚
sil5 	ğ’‚¬
silig2 	ğ’‹¹
silig4 	ğ’‹µ
Å¡ilig 	ğ’‚
Å¡ilig6 	ğ’…—
silim2 	ğ’†—
simed 	ğ’€¸
sir5 	ğ’‰¡
siraÅ¡3 	ğ’‹‹
si-sa2 	ğ’‹›
sub2 	ğ’»
su-ub 	ğ’† 
sub5 	ğ’ˆ°
subur 	ğ’‹š
subur2 	ğ’ˆ›
sud5 	ğ’‚¬
sug6 	ğ’‹¢
sug2 	ğ’»
sug7 	ğ’…²
suh5 	ğ’†ª
suh7 	ğ’ˆ¬
suhuÅ¡2 	ğ’‰Ÿ
suku5 	ğ’…†
sul2 	ğ’‰Œ
sullat2 	ğ’‰º
sullim 	ğ’‚™
sum4 	ğ’…¾
sur4 	ğ’Š¯
sur5 	ğ’‡²
sur8 	ğ’‡¡
tab4 	ğ’™
tal3 	ğ’€¸
tal4 	ğ’¹
teÄ4 	ğ’‹¾
tehi2 	ğ’Œ
dih2 	ğ’Œ
teme 	ğ’‰€
temen 	ğ’‹¼
ten 	ğ’‹¼
teÅ¡lug 	ğ’ˆŠ
tibir3 	ğ’‹¹
tibir5 	ğ’‹µ
tibnu 	ğ’‹¿
tilhar 	ğ’‚¿
tilla 	ğ’Œµ
tir5 	ğ’‰¼
tu14 	ğ’‹ƒ
tu6 	ğ’…²
tu7 	ğ’„°
tu10 	ğ’„½
tuba3 	ğ’‹ƒ
tugure 	ğ’…¤
tum4 	ğ’‰
tur5 	ğ’Œ…
u20 	ğ’Šº
u9 	ğ’‚¦
KUâ‚„ 	ğ’…‡
ubi 	ğ’ƒ´
ubi2 	ğ’‹¦
ubila 	Â¿
ubila2 	Â¿
Å Uâ‚‚ 	ğ’Œ“
udul5 	ğ’Ÿ
udul6 	ğ’­
ug2 	ğ’ŠŠ
ugal 	ğ’†‹
ugu4 	ğ’†ª
ugunu2 	ğ’ƒ½
ukum 	ğ’…–
ul6 	ğ’Œ“
ul5 	ğ’‚¬
ul2 	ğ’‰¡
ulul 	ğ’„’
Å ARâ‚‚ 	ğ’ŒŒ
ula2 	ğ’ƒª
ulal 	ğ’
ulil 	ğ’»
ullu 	ğ’ŒŒ
uman 	ğ’„´
umbara 	ğ’‚¬
umun11 	ğ’†¹
umun12 	ğ’‡©
unu8 	ğ’‘
unu12 	ğ’
unugi 	ğ’€
UÅ â‚‚ 	ğ’…—
uraÅ¡ 	ğ’…
urbigu 	ğ’Œ©
urgilim 	ğ’‰ª
urrub 	ğ’‚
ursub 	ğ’‚
urta 	ğ’…
uru18 	ğ’Œ¸
uru10 	ğ’Š˜
urud2 	ğ’¾
urum3 	ğ’Š˜
urutamga 	ğ’Œ¾
usi 	ğ’ƒ¥
uÅ¡3 	ğ’ƒ£
uÅ¡5 	ğ’‰¦
uÅ¡6 	ğ’‰¥
uÅ¡bar2 	ğ’¬
uÅ¡u 	ğ’€
uÅ¡u3 	ğ’Œ
uÅ¡um 	ğ’€
uÅ¡uÅ¡ 	ğ’ƒ 
uttu2 	ğ’‹ƒ
utul2 	ğ’„°
utuwa 	ğ’­
uzaglal 	ğ’€¹
uzu2 	ğ’¬
zagga2 	ğ’
zaÄa 	ğ’‰Œ
sulug 	ğ’ˆœ
zandara 	ğ’‹ƒ
zanzana 	ğ’„µ
zar3 	ğ’‹§
ze4 	ğ’€“
Å Aâ‚ƒ 	ğ’¥
zikum 	ğ’‡‰
zinanutu 	ğ’„®
zipah 	ğ’ˆ¦
ziz3 	ğ’„®
ziz4 	ğ’„“
zizanu 	ğ’†³
SUDâ‚‚ 	ğ’…—
zukura 	ğ’††
TAKâ‚„ 	ğ’……
Äalga 	ğ’ƒŒ
Äarim2 	ğ’˜
ÄeÅ¡3 	ğ’‘
geÅ¡2 	ğ’¹
URâ‚„ 	ğ’„‘
Å¡a5 	ğ’€
Å¡abalbal 	ğ’†°
HULâ‚‚ 	ğ’¥
Å¡aÄar 	ğ’†¹
Å¡ahan3 	ğ’‚„
Å¡ahan2 	ğ’ˆ²
Å¡ar2-Å¡ar2 	ğ’…—
Å¡ar3 	ğ’ˆ—
Å¡arag 	ğ’Œ“
Å¡aran 	ğ’™
Å¡argad 	ğ’„²
Å¡aru 	ğ’„¶
Å¡aÅ¡ku 	ğ’
Å¡atam 	ğ’ˆœ
Å¡e-X-X 	ğ’Š»
Å¡edu3 	ğ’€†
Å¡edu2 	ğ’Œœ
Å¡ed15 	ğ’…—
Å¡embizi 	ğ’‹†
Å¡embulug2 	Â¿
Å¡embulug3 	ğ’‹Œ
Å¡embulug5 	ğ’‹‰
Å¡emeÅ¡al 	ğ’‹‘
Å¡en2 	ğ’
Å¡en4 	ğ’¾
Å¡ennur 	ğ’„’
Å¡er10 	ğ’ˆ²
Å¡erim 	ğ’‹³
Å¡erim2 	ğ’‡¡
Å¡eÅ¡3 	ğ’€…
Å¡ibir2 	ğ’‚™
Å¡id3 	ğ’‰ª
Å¡ikangu 	ğ’€¿
Å¡il3 	ğ’Œ‹
Å¡ilam 	ğ’‰¦
Å¡allam2 	ğ’‰¥
Å¡ilig7 	ğ’…­
Å¡iri 	|KAÃ—X|
Å¡ub6 	ğ’‹ƒ
Å¡ud3 	ğ’†ƒ
Å¡ukur2 	ğ’‰»
Å¡urum3 	ğ’‡†
Å¡urun4 	ğ’¨
Å¡uÅ¡4 	ğ’‹³
Å¡uÅ¡maÅ¡ 	ğ’€¨
Å¡uÅ¡u 	ğ’…—
Å¡utug 	ğ’‰»
Å¡uzi 	ğ’Œ¨
Äin 	ğ’º
bulug2 	ğ’€
pa2 	ğ’€
nimbar 	ğ’‡
kur5 	ğ’‹»
peÅ¡7 	ğ’Œ‰
pihu2 	ğ’‰¯
bu8 	ğ’”
sah7 	ğ’‹†
tu3 	ğ’
di3 	ğ’‹¾
sig18 	ğ’†¥
dili2 	ğ’‡º
uh4 	ğ’…œ
ursub2 	ğ’†—
uru16 	ğ’‚—
wa2 	ğ’€
ri3 	ğ’†¸
zurzub2 	ğ’†—
Å¡akir3 	ğ’Œ¼
Å¡akira3 	ğ’Œ¼
Å¡ilam2 	ğ’‰¥
Å¡utur 	ğ’ˆ¤
min2 	ğ’Š©
duruna2 	ğ’‡Œ
henbur 	ğ’†•
kig2 	ğ’†¥ 	

# AUTO 2

lah5 	ğ’ºğ’º
lah2 	ğ’‚Ÿ
lahar 	ğ’‡†ğ’„
lahar2 	ğ’±
lahhuÅ¡u 	ğ’‹ğ’‹ğ’‹™
lam7 	ğ’„‘ğ’‡µ
lamahuÅ¡ 	ğ’£ğ’£ğ’†¸
la'u 	ğ’‡³
la'u3 	ğ’‡³ğ’‰Œ
la'u4 	ğ’‡³ğ’†•
la'u5 	ğ’‡³ğ’€€
lidda2 	ğ’Š®ğ’¹
lidim 	ğ’€¢
ligidba 	ğ’‹†ğ’€­ğ’Š©ğ’Œ†ğ’…
lil3 	ğ’‹™ğ’Œ‹ğ’Œ‹ğ’Œ‹
lil5 	ğ’‹™ğ’‰ˆ
limmu3 	ğ’˜
liri4 	ğ’€‰ğ’†—
liri5 	ğ’€‰ğ’€¸
lu10 	ğ’–ğ’†¨Â·x
lugud4 	ğ’‡­ğ’‹§
luÄa 	ğ’‰ºğ’‚·
luhÅ¡a 	ğ’„´ğ’ˆ¨ğ’Œ‹
luhum 	ğ’ˆğ’ˆ
lukur 	ğ’Š©ğ’ˆ¨
f 	ğ’Š©ğ’‡½ğ’‰ğ’·ğ’ˆ¾
lulim 	ğ’„ŠÂ·ğ’‡»ğ’…†
Eâ‚‚ 	ğ’ˆ¦ğ’„˜ğ’ƒ¼
DIM4 	ğ’‰½ğ’‰½
dinig2 	ğ’‡½Â·ğ’ˆ¨ğ’‚—
ELLES316 	Â¿
emengi 	ğ’…´ğ’„€
gabar 	ğ’‰ºğ’£
GAM+GAM 	ğ’ƒµğ’ƒµğ’„©
ganzer2 	ğ’‰ˆğ’‹›ğ’€€
gar10 	ğ’‚µğ’‰Œ
garadin4 	ğ’†¸ğ’†¸
GEÅ TUG2 	ğ’„‘ğ’Œ†ğ’‰¿ğ’Šºğ’‰€
girah 	ğ’‹—ğ’¶
girid2 	ğ’„ŠÂ·ğ’ƒ·@t
guhÅ¡u2 	ğ’ˆğ’ˆğ’‹™
gur21 	ğ’‚Šğ’Œˆ
gur9 	ğ’‰’
gurdub2 	ğ’‚·Â·ğ’„„
imÄaÄa3 	ğ’€¾ğ’€­
imÄaÄa2 	ğ’€¾ğ’€­ğ’ˆ¾
imhur4 	ğ’…†ğ’€€
imhur2 	ğ’…†ğ’‰
imhur3 	ğ’…†ğ’‚µ
immal3 	ğ’ƒ»ğ’‹—ğ’‚‚
imminte 	ğ’…´ğ’‹¼
irgi 	ğ’„Šğ’
kaÅ¡bir 	ğ’‰ğ’€€ğ’‹¤
kuÅ¡lug 	ğ’† ğ’‰ˆ
mabi2 	ğ’€€ğ’ˆ¹ğ’²
madal 	ğ’„‘ğ’
malla 	ğ’„‘ğ’
maÅ¡kim 	ğ’‰ºğ’½
maÅ¡min 	ğ’ˆ¦ğ’ˆ«
me9 	ğ’†¸Â·Å¡ita@tğ’„‘
me11 	ğ’€Â·ğ’‹–ğ’„‘
megida 	ğ’‹°ğ’‹¾
mel3 	ğ’† ğ’‰ˆ
men4 	ğ’‡˜ğ’‚—
mermer3 	ğ’…?
meze 	ğ’€–Â·ğ’ˆ¨ğ’‚—
mim2 	ğ’ˆ¹
minbulug2 	ğ’‘ğ’‘
mudru2 	ğ’‚—ğ’†ªğ’€€
mudra6 	ğ’ˆ¬ğ’
mulu4 	ğ’ƒ·ğ’
munu3 	ğ’‚·Â·ğ’´Â·ğ’Šº
munsub2 	ğ’‹ ğ’‡´ğ’‹¦
munu2 	ğ’† ğ’‰ˆ
munzer 	ğ’† ğ’€­ğ’‹€ğ’† 
mur10 	ğ’Œ†
murub2 	ğ’Š©ğ’‡¬
murub3 	ğ’‚—ğ’ˆ¨ğ’‡¬
murum5 	ğ’Š©ğ’Œ“ğ’‚”
murum4 	ğ’Œ«Â·ğ’Œ‘ğ’€¸
uru8 	ğ’Œ«
muzug 	ğ’Œ‘ğ’Š•
muzug2 	ğ’Œ‘ğ’…—
nab 	ğ’€­ğ’€­
nenkum 	ğ’Š©ğ’Œ†ğ’‰½ğ’…Šğ’‰£ğ’ˆ¨ğ’‚¬
ne4 	ğ’‹™ğ’‰ˆ
nigru 	ğ’…™ğ’†¬
niÄar 	ğ’Œ‹ğ’Œ“ğ’†¤
niÄin5 	ğ’‡³ğ’†¸
niÄin9 	ğ’‡²ğ’Š¬
niÄin3 	ğ’Œ‹ğ’Œ“ğ’†¤
Å U+TAG4 	ğ’‹—ğ’‹º
nimur 	ğ’† ğ’‰ˆ
nindaba 	ğ’‰»ğ’€­ğ’ˆ¹
numma 	ğ’‰¢ğ’‰¢ğ’“ğ’“ğ’„·
nunuzzi 	ğ’‚—ğ’‰­ğ’£ğ’€­ğ’Œ“
pagra3 	ğ’‡½Â·ğ’˜
palil2 	ğ’…†ğ’‚ ğ’ºğ’‚Ÿ
pa6 	ğ’‰½ğ’…–
pil6 	ğ’‰¢
piÅ¡10 	ğ’† ğ’€€
puglu 	ğ’Š®ğ’„€
puzur4 	ğ’…—Â·ğ’ƒ·@tğ’Š­
puzur3 	ğ’Œ‹ğ’ 
rab3 	ğ’„‘ğ’ˆ—
RIG7 	ğ’‰ºğ’„¸ğ’º
rig10 	ğ’‰ºğ’£
rig9 	ğ’„¸ğ’º
sag2 	ğ’‰ºğ’ƒ¶
sig11 	ğ’‰ºğ’ƒ¶
sagdul 	ğ’Œ‹ğ’Š•
saÄa2 	ğ’Š«
saÄa4 	ğ’…ğ’†
saÄa3 	ğ’…ğ’ˆ£ğ’…Š
saÄa5 	ğ’‚µğ’šğ’…Š
saÄa6 	ğ’‚µğ’ˆ£ğ’…Š
saÄmaÅ¡ 	ğ’ğ’†œ
sagmaÅ¡ 	ğ’ğ’†œ
saÄmin 	ğ’ˆ¦ğ’Œ‹ğ’Œ‹
samag2 	ğ’Œ 
samag4 	ğ’Œ¡ğ’†¸
saman 	ğ’‚ ğ’‹¤ğ’‰£ğ’‚ ğ’Œ…
santana 	ğ’ƒ²ğ’‰Œ
sed6 	ğ’ˆ¹
Å¡e12 	ğ’€€ğ’ˆ¹
Å¡e18 	ğ’€€ğ’ˆ¹ğ’²
Å¡e15 	ğ’Šºğ’‰£ğ’‰£
Å¡e5 	ğ’ğ’ˆ¹ğ’²
Å¡ed5 	ğ’†’
si5 	ğ’…†ğ’‚ 
sibsib 	ğ’…´ğ’ˆ¨
sig8 	ğ’ƒ°ğ’‹ºğ’„‘
sikin 	ğ’‹ ğ’‡´
silig5 	ğ’„‘ğ’Œ·Â·ğ’
silig3 	ğ’‹¸
sisi 	ğ’€²ğ’†³ğ’Š
siÅ¡kur2 	ğ’€¬ğ’€¬
sa5 	ğ’‹›ğ’€€
su9 	ğ’¯ğ’€€
sud3 	ğ’‹¢ğ’†³ğ’Š’
sugin 	ğ’„‘ğ’
suhirim 	ğ’‡­ğ’‹§
suhub2 	ğ’€¯
suhul 	ğ’‹™ğ’€¯
sukuÅ¡ 	ğ’ˆ¹
sulgar 	ğ’‹™ğ’€¯
suluhu 	ğ’‹ ğ’‹¤
suluhu3 	ğ’£ğ’£ğ’†¸
sulummar 	ğ’† ğ’Š•ğ’º
sum5 	ğ’»ğ’»ğ’»ğ’»
sumunda 	ğ’‡¯ğ’‡¯ğ’Šº
sur6 	ğ’† ğ’ƒ²
sur7 	ğ’† ğ’†•
surru 	ğ’‹ª
tal5 	ğ’†“ğ’†“
tan2 	ğ’‚·Â·ğ’ˆ¨ğ’‚—
targul 	ğ’ˆ£ğ’ˆ®
taÅ¡karin 	ğ’„‘ğ’Œ†
taskarin 	ğ’„‘ğ’Œ†
TAxÅ E 	ğ’‹«ğ’Šºğ’„©
ten3 	ğ’‚…Â·ğ’†¦ğ’†¦
teÅ¡bi 	ğ’Œ‘
ti8 	ğ’€‰ğ’„·
tibir4 	ğ’‹¸
tigidla 	ğ’Š®ğ’‹»
tigidla3 	ğ’Š®ğ’ˆ«ğ’²
tilla2 	ğ’€­ğ’€¸ğ’€­
tilla3 	ğ’€­ğ’¹ğ’€­
tilla4 	ğ’€­ğ’€¸ğ’€€ğ’€­
tilla5 	ğ’€­ğ’€¹ğ’€­
tir4 	ğ’‹›ğ’€€
tirigi 	ğ’Š•ğ’€­
titab2 	ğ’ˆ–ğ’‰½ğ’‰½
TU9 	ğ’Œ†ğ’€
tuhul 	ğ’‰„ğ’
tukumbi 	ğ’‹—ğ’ƒ»ğ’Œ‰ğ’‡²ğ’‰
tungal 	ğ’‚—ğ’ª
tungal2 	ğ’‚—ğ’† 
turan 	ğ’„™ğ’„’
u10 	ğ’±
HUBâ‚‚ 	ğ’Œ‘
ub3 	ğ’€–Â·ğ’Š®
ub6 	ğ’€–Â·ğ’ˆ¨ğ’‚—
ubri 	ğ’…†ğ’†•
ubri2 	ğ’…†ğ’´
udra 	ğ’‰ğ’Œ‘ğ’Š“
udul3 	ğ’¦ 	ğ’–ğ’†¨Â·ğ’‡»ğ’ˆ§
udul4 	ğ’‰ºğ’¦ 	ğ’–ğ’†¨Â·ğ’‡»ğ’ˆ§
udul10 	ğ’€–ğ’‡»
udul9 	ğ’‰ºğ’£ 	ğ’–ğ’†¨Â·ğ’†•
udun 	ğ’Œ‹ğ’ˆ¬
ug7 	ğ’…—
ugra 	ğ’†¸Â·ğ’Œ‘ğ’€¸
ugu2 	ğ’€€ğ’…—
ugu3 	ğ’€€ğ’Š•
ugudil 	ğ’‰’Â·ğ’Œ‘ğ’€¸
uh6 	ğ’…ğ’‹™
uktin 	ğ’…Šğ’€©
ukur2 	ğ’ƒ²ğ’‹š
ukurrim 	ğ’‚—ğ’ˆ¨ğ’€­ğ’ˆ¹
ulul2 	ğ’ƒ·?
uludin2 	ğ’…Šğ’€©
ulumaÅ¡ 	ğ’…ğ’ƒ·ğ’„´ğ’ˆ¨ğ’Œ‹
ulumaÅ¡2 	ğ’…ğ’„´ğ’ˆ¨ğ’Œ‹ğ’ƒ·
uluÅ¡in2 	ğ’‰ğ’€¾ğ’€­ğ’ˆ¾
ubiÅ¡aga 	ğ’‹°ğ’‹°ğ’‰Œğ’‰Œğ’¹ğ’¹
umun10 	ğ’Œ‹ğ’ˆ¬
umun5 	ğ’‡¥ğ’€€
umun6 	ğ’†¸Â·ğ’„­Â·ğ’‰£
unu10 	ğ’„€?
unud 	ğ’€–ğ’†ª
unu9 	ğ’†’
uru6 	ğ’‰’Â·ğ’Œ‘ğ’€¸ğ’„©
uru7 	ğ’Œ«Â·ğ’Œ‘ğ’€¸ğ’„©
uru12 	ğ’Œ†
uru9 	ğ’‹ğ’…‚
uru15 	ğ’‹€ğ’€Š
us5 	ğ’‡†ğ’„
NAâ‚‚ 	ğ’Œ‘ğ’Š©ğ’†·
usandu 	ğ’„·ğ’†•
usar 	ğ’‡³ğ’Š¬
usil 	ğ’‚³
usu 	ğ’€‰ğ’†—
usud 	GA2Ã—ANğ’†•ğ’€€
usuh 	ğ’Š©ğ’‡¬
usur4 	ğ’‡²ğ’†¸
uÅ¡15 	ğ’‹›ğ’€€
uÅ¡bar3 	ğ’Œ«Â·ğ’Œ‘ğ’€¸
uÅ¡bar5 	ğ’Œ‹ğ’‚˜@t
uÅ¡era 	ğ’†¸Â·ğ’Œ‘ğ’€¸
uÅ¡tuh 	ğ’† ğ’…
uÅ¡ub 	ğ’‹›ğ’€€
uÅ¡umgal 	ğ’ƒ²ğ’”
utah 	ğ’Œ‹ğ’‚µ
utte 	ğ’† ğ’† 
uttuku 	ğ’ƒ»ğ’‹ƒ
utu2 	ğ’Œ‹ğ’‚µ
utu5 	ğ’€¾
utuwa2 	ğ’¦ 	ğ’–ğ’†¨Â·ğ’‡»ğ’ˆ§
uzug5 	ğ’†ˆ
uzug2 	ğ’Œ‘ğ’…—
uzug3 	ğ’Œ‘ğ’Š•
uzug4 	ğ’Œ‘ğ’†³ğ’‰Œğ’Œ‡ğ’† 
za2 	ğ’‰Œğ’Œ“
zabar3 	ğ’†‰ğ’‡
zabitum 	ğ’„‘ğ’†ğ’Œ‰
zah2 	ğ’„©ğ’€€
zahan2 	ğ’Œ‹ğ’‚µ
zamin 	ğ’Œ’ğ’Š‘
zanabal 	ğ’‡½Â·ğ’†·ğ’€¸
zanabal2 	ğ’‡½Â·ğ’†‘ğ’€¸
zanabal3 	ğ’‡½Â·ğ’‹›ğ’€¸
zanaru 	ğ’ˆ¹
zanbur 	ğ’ğ’†œ
zansur 	ğ’‡¥ğ’Œ‹ğ’Œ‹
zapah 	ğ’‹—ğ’
zara6 	ğ’ğ’€¸ğ’Œ†
zarah2 	ğ’‡»ğ’† ğ’†•
zibin 	ğ’«
zibin2 	ğ’¬ 	ğ’–ğ’†¨ Â·ğ’Œ‘ğ’„ˆ
zigara 	ğ’…?
zikura 	ğ’†œğ’‹
zilulu 	ğ’‰ºğ’‡
zipah2 	ğ’‹—ğ’
zir2 	ğ’‚ ğ’…—
zirru 	ğ’‚—ğ’‰­ğ’£ğ’€­ğ’‹€ğ’† 
zizna 	ğ’Œ‰ğ’Œ‰ğ’ğ’ğ’„©
ZUBUD@g 	ğ’†¦Â·ğ’„ªğ’„©
geÅ¡bu 	ğ’„‘ğ’Š’
ÄeÅ¡bun2 	ğ’† ğ’‰
ÄeÅ¡nu 	ğ’‰¢
geÅ¡nu2 	ğ’‰¢ğ’…•
ÄeÅ¡pu2 	ğ’„‘ğ’‹—ğ’‰½ğ’‰½
ÄeÅ¡tae 	ğ’Â·ğ’˜Â·ğ’†³
Äes 	ğ’„·ğ’ƒ¾ğ’Œ“ğ’€€
ÄeÅ¡tug2 	ğ’„‘ğ’Œ†ğ’‰¿
gizzal2 	ğ’‰¢ğ’‹¡
Å¡abra2 	ğ’‰ºğ’‚
sagi 	ğ’‹¡ğ’‹—ğ’ƒ®
Å¡aÄa 	ğ’‡½Â·ğ’ƒ·@t
Å¡akaka 	ğ’† ğ’‡´
Å¡akanka 	ğ’† ğ’‡´
Å¡akkan6 	ğ’€²ğ’€´
Å¡agina 	ğ’„Šğ’€´
Å¡amanur 	ğ’ğ’…–ğ’
Å¡anna 	ğ’ƒ·ğ’
Å¡ara3 	ğ’‡£
Å¡arap 	ğ’†—ğ’‚”
Å¡e21 	ğ’„·ğ’ˆ¿
Å E+DIN 	ğ’Šºğ’·
Å¡eg12 	ğ’‹
Å¡eg4 	ğ’€€ğ’‹™ğ’‰€
Å¡erimsur 	ğ’†¸Â·ğ’Šºğ’‹§
Å¡eÅ¡lam2 	ğ’‚—ğ’ˆ¨ğ’‡·
Å¡ikahara 	ğ’‹ğ’‹ğ’‹™
Å¡imaÅ¡ki 	ğ’‡»ğ’‹¢
Å¡imaÅ¡ki2 	ğ’‡»ğ’‹¢ğ’€€
Å¡imbirida 	ğ’Œ‘ğ’†³ğ’Šğ’Š¬
Å IR3 	ğ’‚¡ğ’ˆœ
Å¡iten 	ğ’† ğ’ºğ’†•
Å¡ub5 	ğ’„Š
Å¡uba2 	ğ’ğ’ˆ¹
Å¡uba3 	ğ’ˆ¹ğ’
Å¡uba4 	ğ’ˆ¹
Å¡ubba 	ğ’‚¡Â·ğ’„·
Å¡ubtu3 	ğ’†œğ’†¸
Å¡ubtu5 	ğ’†œğ’‡¥
Å¡ubtu4 	ğ’†œğ’†œğ’†¸ğ’†¸
Å¡ugi 	ğ’‹—ğ’„€?
Å¡ukbar 	ğ’„‘ğ’‹—ğ’†—
Å¡un2 	ğ’€¯
Å¡ur6 	ğ’‡³ğ’†¸
Å¡urmen 	ğ’‹—ğ’ˆ¨ğ’‚
Å¡urun2 	ğ’‡£
Å¡uÅ¡5 	ğ’‡Ÿ
Å¡uÅ¡um 	ğ’ˆ¹ğ’‚
Å¡utug2 	ğ’„´ğ’ˆ¨
Å¡utul6 	ğ’Œ‹ğ’†¤
Å¡utum2 	ğ’‚ğ’„€ğ’ˆ¾ğ’€Šğ’Œ‹ğ’„
megida2 	ğ’‹°ğ’†²
mud4 	ğ’†¸ğ’Œ‹ğ’†•
mud8 	ğ’‰­ğ’€–Â·ğ’†‘
muru5 	ğ’Š©ğ’Œ“ğ’‚”
nir5 	ğ’ğ’…
nir4 	ğ’ğ’‹¢
Å¡akan6 	ğ’„Šğ’€´
Äiskim 	ğ’…†ğ’¾
menbulug2 	ğ’‘ğ’‘
pala3 	ğ’‰†ğ’Š©ğ’Œ†
pala2 	ğ’‰†ğ’‚—
peÅ¡10 	ğ’† ğ’€€
asar2 	ğ’€€ğ’Œ…ğ’ƒ®ğ’‡º
pihu3 	ğ’…—ğ’†•
pihu4 	ğ’‰ğ’Œ‘ğ’Š“
pihu5 	ğ’‘ğ’Š“
sib2 	ğ’‰ºğ’‡»
ulu2 	ğ’„´ğ’ˆ¨ğ’Œ‹
zermuÅ¡ku 	ğ’‹ºğ’€©
zermuÅ¡kux 	ğ’‹ºğ’€©
tuku2 	ğ’Œ†
Å¡aman2 	ğ’Œ‹ğ’ƒ¶
dabaÅ¡in 	ğ’†¯
esir4 	?ğ’„€?
esir5 	ğ’„„?
guda2 	ğ’„´ğ’ˆ¨
nisaba 	ğ’Šºğ’‰€ğ’„©
henbur2 	ğ’Šºğ’†•

ma5 	ğ’…¡
niÄir 	ğ’‚…Â·ğ’†¦ğ’†¦
silaÄ 	ğ’‹ƒ
suh10 	ğ’ˆ¹
teÅ¡2 	ğ’Œ¨
umuÅ¡ 	ğ’Œ†
unkin 	ğ’…—
ur14 	ğ’ƒ£
uÅ¡7 	ğ’…²
uzud 	ğ’š
ÄeÅ¡nimbar 	ğ’„‘ğ’Š·
Å¡e8 	ğ’‹
Å¡idim 	ğ’¶
Å¡ita2 	ğ’„‘?
mar6 	ğ’…—
tarah 	ğ’°
lim4 	ğ’‰ˆ
sub3 	ğ’‰­ğ’€–Â·ğ’†‘
nus 	ğ’‰­
zug4 	ğ’…²
