1 𐤀 א
2 𐤁 ב
3 𐤂 ג
4 𐤃 ד daletʳ
5 𐤇 ה ᵖhe ᶝhe
6 𐤅	ו ˢvov ?
7 ז za'in 
8 ת het 
9 ט


A	𐤀	ܐהא	
B	𐤁	ב
C	𐤂	חכךג	
D	𐤃	טד	ע
E	𐤄	עה	
F	𐤅	ףפבוו
G	𐤂	גע	
H	𐤇	חה	
I	𐤉	י	
J	𐤉	וי	
K	𐤊	קכך	
L	𐤋	ל	
M	𐤍	מם	 ל SIC!!!
N	𐤌	נןמ	
O	𐤏	עס	
P	𐤐	פף	
Q	𐤒	ק	
R	𐤓	ר	
S	𐤑	צץס	
T	𐤕	תטצ ד	
U	𐤅	עו	
V	𐤅	וב	
W	𐤅	וו	
X	𐤎	ס	
Y	𐤅	ייוע	
z	𐤆	צז	
z	𐤔	ש sh
ʒ	𐤈	ט	
š 𐤔/𐤑	ש