Cypriot

The CYPRIOT or Cypriote syllabary is a syllabic script used in Iron Age Cyprus, from about the 11TH TO THE 4TH CENTURIES BCE, when it was replaced by the Greek alphabet. A pioneer of that change was king Evagoras of Salamis. It is descended from the Cypro-Minoan syllabary, in turn a variant or derivative of Linear A. Most texts using the script are in the Arcadocypriot dialect of Greek, but also one bilingual (Greek and Eteocypriot) inscription was found in Amathus.

VS parent

The CYPRO-MINOAN syllabary (CM) is an undeciphered syllabic script used on the island of Cyprus during the late Bronze Age (ca. 1550â€“1050 BC). Visual similarity to Linear A on Minoan Crete, from which CM is thought to be derived.[1] Approximately 250 objectsâ€”such as clay balls, cylinders, and tablets and votive standsâ€”which bear Cypro-Minoan inscriptions, have been found. Discoveries have been made at various sites around Cyprus, as well as in the ancient city of Ugarit on the Syrian coast.

Parent systems : Linear A

ğ“® = U : ğ ± TU  ğ ˜ MU ğ  NU ğ “ LU 	L+U
E: ğ ‹KE
PO ğ   Oğ ƒ Sğ «


 	-a 	-e 	-i 	-o 	-u
	ğ € 	ğ  	ğ ‚ 	ğ ƒ 	ğ „
w- 	ğ ² 	ğ ³ 	ğ ´ 	ğ µ 	
z- 	ğ ¼ 			ğ ¿ 	
j- 	ğ … 			ğ ˆ 	
k-, g-, kh- 	ğ ŠAXğ“‰¼ 	ğ ‹ 	ğ Œ 	ğ  	ğ 
l- 	ğ  	ğ  	ğ ‘ 	ğ ’ 	ğ “
m- 	ğ ” 	ğ • 	ğ – 	ğ — 	ğ ˜
n- 	ğ ™ 	ğ š 	ğ › 	ğ œ 	ğ 
ks- 	ğ · 	ğ ¸ 			
p-, b-, ph- 	ğ  	ğ Ÿ 	ğ   	ğ ¡ 	ğ ¢
r- 	ğ £ 	ğ ¤ 	ğ ¥ 	ğ ¦ 	ğ §
s- 	ğ ¨ 	ğ © 	ğ ª 	ğ « 	ğ ¬
t-, d-, th- 	ğ ­ 	ğ ® 	ğ ¯ 	ğ ° 	ğ ±

A		ğ €	AN * stern +++
E 	ğ 
I 	ğ ‚
O 	ğ ƒ		PO ğ   Oğ ƒ SO ğ « ZO ğ ¿ â†” SHU !?
U 	ğ „		UVW WAV Y
WE 	ğ ³		WI!


WA	ğ ²
WE 	ğ ³
WI 	ğ ´
WO 	ğ µ 	
ZA 	ğ ¼
ZO	ğ ¿
ZU 	ğ ¼ ~ XU
JA	ğ …
JO	ğ ˆ
KH/GA	ğ Š	â†” ä¸‹ xiÃ  ğ ° DOwn
KH/GE 	ğ ‹ K+E
KH/GI 	ğ Œ
KH/GO 	ğ 
KH/GU 	ğ  ğ 	â†” KS*
LA 	ğ 
LE 	ğ 	?? Limes?
LI 	ğ ‘	?
LO 	ğ ’	P+LUs
LU 	ğ “	L+U
MA	ğ ”	M+?
ME 	ğ • M+E?
MI 	ğ – M+I
MOy	ğ — !
MUx	ğ ˜	Medi
NA	ğ ™ Â¬ NOT? ğ“ˆ–T?
NE 	ğ š	EN:IN? â†” ğ Ÿ PE !?
NI 	ğ ›	Nei(gung)?
NO 	ğ œ	ğ“‚œ
NU 	ğ 	ğ“‚œ	KeiN ;)
KS	ğ ·		X! C~S @ Russia!
KSE ğ ¸		vs CD
KSU	ğ ¼ ~ XU/ZA
PA  ğ 	â†” Ï€ 'pai' ğ’‰º ğ  åŒ¹ pÇ 
PE	ğ Ÿ	!?
PI 	ğ  	 
PO 	ğ ¡	P ğ€¡ ğ“Š¹ ?
PU 	ğ ¢ boat
RA 	ğ £ vs WOHM!?
RE 	ğ ¤ !?
RI 	ğ ¥ ?
RO 	ğ ¦ !? ~ rho?
RU 	ğ § !? â†” round?
SA 	ğ ¨ğ ¨	Î£a Ca Zayin ğ ¨ğ ¨ Zahn 
SE 	ğ ©	å±± shÄn ğ ¯ ä¸Šä¸‹ shÃ ng
SI 	ğ ª
SO 	ğ «
SU 	ğ ¬		[Sagitaur?]
DA 	ğ ­
DE 	ğ ®		 	
DI 	ğ ¯ ä¸Š shÃ ng å±± shÄn vs
DO 	ğ °	DOWN(ä¸‹ xiÃ ) 
DU 	ğ ±	DUO 2
TA 	ğ ­	å¤ªâ€‹ tai å¤§ da ğ ¯
TE 	ğ ®
TI 	ğ ¯	TIP
TO 	ğ °	TOP
TU 	ğ ± TWO 2


Origin

It has been established that the Cypriot syllabary is derived from the Linear A script and most probably, the Minoan writing system. The most obvious change is the disappearance of ideograms, which were frequent and represented a significant part of Linear A. The earliest inscriptions are found on clay tablets. Parallel to the evolution of cuneiform, the signs soon became simple patterns of lines. There is some evidence of a Semitic influence due to trade, but this pattern seemed to have evolved as the result of habitual use.[1]
Structure

The structure of the Cypriot syllabary is very similar to that of Linear B. This is due to their common origin and underlying language (albeit different dialects).[1] The Cypriot script contains 56 signs.[2] Each sign generally stands for a syllable in the spoken language: e.g. ka, ke, ki, ko, ku etc. Hence, it is classified as a syllabic writing system.[3] Because each sign stands for an open syllable (CV) rather than a closed one (CVC), the Cypriot syllabary is also an 'open' syllabary.[2]


Differences between Cypriot syllabary and Linear B
The main difference between the two lies not in the structure of the syllabary but the use of the symbols. Final consonants in the Cypriot syllabary are marked by a final, SILENT E. For example, final consonants, n, s and r are noted by using ne, re and se. Groups of consonants are created using extra vowels. Diphthongs, such as ae, au, eu and ei, are spelled out completely. In addition, nasal stops which occur before another consonant are omitted completely.
Compare Linear B ğ€€ğ€µğ€«ğ€¦ (a*-to-ro-po[s]) to 
Cypriot ğ €ğ °ğ ¦ğ ¡ğ © (an-to-ro-po-s), both forms of 
standard á¼„Î½Î¸ÏÏ‰Ï€Î¿Ï‚ (anthrÅpos) "human".

In the Linear B script, liquid sounds /l/ and /r/ are covered by one series, while there are separate series for the dentals /d/ and /t/. In the Cypriot syllabary, /d/ and /t/ are combined, whereas /l/ and /r/ are distinct!! <<<

The script was deciphered in the 19th century by George Smith due to a Phoenician-Cypriot bilingual inscription found at Idalium.  <<<

About 1000 inscriptions in the Cypriot syllabary have been found throughout many different regions. However, these inscriptions vary greatly in length and credibility.[3] Most inscriptions found are dated to be around the 6th century. There are no inscriptions known to be before the 8TH CENTURY. Most of the tablets found are from funerary monuments and contained NO USEFUL information but NAME of the deceased. A few dedicatory inscriptions were also found but of very little contribution to decipherment. The most important tablets are mainly found in Enkomi and Paphos.
