original ordering:
[ᚠ] 	ᚢ 	ᚦ 	ᚨ 	ᚱ 	ᚲ 	ᚷ 	[ᚹ] 	ᚺ 	ᚾ 	ᛁ 	ᛃ 	ᛈ 	ᛇ 	ᛉ 	ᛊ 	ᛏ 	ᛒ 	ᛖ 	ᛗ 	ᛚ 	ᛜ 	ᛞ 	ᛟ
[f] 	u 	þ 	a 	r 	k 	g 	[w] 	h 	n 	i 	j 	p 	ï 	z 	s 	t 	b 	e 	m 	l 	ŋ 	d 	o 

1. ᚠ Fieh 一 fyi   一 first al'phai!
2. ᚢ ur 	入 èr    二 儿人入 urtavr? ->
3. ᚦ þ* 	山 þan   三 third þurisanz Thor
4. ᚨ ƒa*  火 fhour 四 four (Viecher!) fA QED before!!
5. ᚱ rwun 五 ƒrwn  五 (run/ride/round/fahren/farvan)
6. ᚲ cics 巳 Sìs   巳 𐀱 six
7. ᚷᚹ! giba	 七 Qība 七 7 gift+ givan (wonne𓏠)
8.  ᚺ  bHag  八
9.  ᚾ  naud / naun  (一ᛁ=ᚾ IX=9! ) njiǔn 九~ᚾ ƒ
10. ᛁ0 zain! I

8. ᚹ okwa 八 oxba 八 wonne𓏠 poxt? --- ??
9. ᚺ jiǔn 九  gāun kiūln hageln -- 구 (九, gu) く ku vs ᚲ !! ----
10.ᚾ XN theN 什 shiN See-Not / need knot?


F ᚨ:A ᚨ:fA ᚠ:Fe ᛓ:B! ᚡ:Vi!	 ᚩ vOs ᚪ vAc ᚫ AESC--
A ᚢ:U ᚤ:Y ᚣ:YR ᚥ:Wr
B ᛒ:B ᛈ:Pc/Both ᛞ:D!  ᚿ:buN ᛓ:B! see ᚠ:F…
C ᚲ:C ᛈ:Pc/Ps ᚳ:K ᚴ:K	ᚵ:G ENG:ᚶ GER:ᛄ GAR:ᚸ ᛃ:J
D ᚦ:TH ᚧ:ETH ᛞ:D! ᛞᛗ DORMEN = 鬥門dǒurmen dolmen!!
E ᚭ:Oe ᛖ:mE ᛂ:Eh/He
F ᚨ:fA ᚠ Fe  ᚡ Vi	 ᚩ vOs ᚪ vAc ᚫ AESC--
G ᚵ:G ENG:ᚶ GAR:ᚸ GER:ᛄ crc:ᛤ ᛝ:xING! ᛃ:J
H ᚺ:H ᚻ:H ᚽ:Hi/He/Eh
I ᛁ:I ᛇ:J ᚽ:Hi ᛙ:Mi ᛧ:IR ᛨ:YR ᛠ:iEAR ᛡ:xIOR
J ᛇ:J ᛃ:J ᛁ:I ᚽ:Hj
K ᚳ:K ᚴ:K ᚲ:caun ᛕ:kP! κ
l ᛚ:L  ≠ ᚳ cen
M ᛗ:Ma ᛖ mE  ᛗᛁmi  ᛗᛟ mo ᛗᚢ mu ᛙ:Mi ᛘ:M! MADR
N ᚾ:No ᚿ:buN ᛀ:No ᛅ:A¬ ᛆ:A¬ ᛅ:un ᛆ:un ᛝ:xING!
O ᛟ:O ᛜ:oINGWAZ	 ᚬ:O ᚭ:fO ᚮ:bO ᚯ:fOE ᛅ:A¬ ᛆ:A¬ ᚰ:ON ᚾ:No! ᛁ:oI ᛇ:J 
P ᚹ:ph=W ᚡ:PH/V ᛈ:Pth! ᛕ:Pk! ᛩ:Qv
Q ᛩ:Q ᛄ:GER/quer/kur ᛟ:O  ᛰ:*zhong
R ᚱ:R ᛨ:YR ᛡ:xIOR ᛦ:YR vs 𐀩:L/R! ≠ ᛉ
S ᛊ:S ᛋ:Z aS:ᛌ aC:ᛍ aZ:ᛎ ᛜ:sINGWAZ
T	ᛏ T  ᛐ DÞþ𐊮ᚦ ᛑ Z	ᛎ  
U ᚢ:U ᚤ:Y ᚣ:YR ᚥ:Wr
V ᚢ:U ᚡ:Vi! ᚨ:Fa ᚹ:ph=V
W ᚥ:Wr ᚹ:ph=W 
X ᚷ:Gs ᛝ:xING! ᚼ:xH ᚼ:cHi ᛪ:Xz ᛞ:D! ᛡ:xIOR
Y 𐀩~ᛦ:YR ᛨ:YR ᛧ:IR ᛇ:Jahr/ᛃ:year ᛠ:yEAR ᛉ?
Z ᛋ:Z ᛊ:S 𐀩≠ᛉ:𓋹@𐀔

A ᛅ:A¬ ᛆ:A¬ ᛅ:un ᛆ:un ᛝ:xING! ᚨ:fA ᚠ Fe  ᚡ Vi	 ᚩ vOs ᚪ vAc ᚫ AESC--
E ᚭ:Oe ᛖ:mE ᛂ:Eh/He H ᚺ:H ᚻ:H ᚽ:Hi/He/Eh
I ᛁ:I ᛇ:J ᚽ:Hi ᛙ:Mi ᛧ:IR ᛨ:YR ᛠ:iEAR ᛡ:xIOR
O ᛟ:O ᛜ:oINGWAZ	 ᚬ:O ᚭ:fO ᚮ:bO ᚯ:fOE ᛅ:A¬ ᛆ:A¬ ᚰ:ON ᚾ:No! ᛁ:oI ᛇ:J 
U ᚢ:U ᚤ:Y ᚣ:YR ᚥ:Wr

a 	ᚨ 	a 	/a(ː)/ 	*ansuz 	"one of the Æsir (gods) An*Zeus vs 𐌰 AHSA	God"
b 	ᛒ 	b 	/b/ 	*berkanan 	"birch"
c 	ᚲ 	c/k	/k/ 	*kaunan 	"ulcer" *kenaz "torch" ƒƒ
þ   ᚦ 	þ 	/θ/, /ð/ 	*þurisaz 	"the god Thor, giant 
d 	ᛞ 	d 	/d/ 	*dagaz 	"day", "Dächer?"
e 	ᛖ 	e 	/e(ː)/ 	*ehwaz 	"horse" ↔ ᛖärez ehwaz equus / hewaz ᛖhorse
f 	ᚠ 	f 	/f/ 	*fehu 	"wealth, cattle" ↔ Viech,viel Vieh ≠ ᚩ Os ≠ ᚪ Ac
g 	ᚷ 	g 	/ɡ/ 	*gebō 	"gift" Gabe
h 	ᚺᚻ 	h 	/h/ 	*hagalaz "hail"  vs ᛖ ehwaz equus / hewaz horse
i		ᛁ,ᛇ 	i,æ,eī 	 	/i(ː)//æː/	*īsaz 	"ice", *eī(h)waz 	"yew-tree"
j 	ᛃ,ᛇ 	j 	/j/ 	 *jēra- 	"year,harvest"
k 	ᚲ 	k (c) 	/k/ 	*kaunan 	"ulcer" *kenaz "torch"
l 	ᛚ 	l 	/l/ 	*laguz 	"water, lake" *laukaz "leek" ≠ ᚳ cen
m 	ᛗ 	m 	/m/ 	*mannaz 	"Man" vs ᛖäre (horse)
n 	ᚾ 	n 	/n/ 	*naudiz 	"need","Not" Naut knot?
o 	ᛟ 	o 	/o(ː)/ 	*ōþila-/*ōþala- 	"heritage, estate, possession"
p 	ᛈ 	p 	/p/ 	*perþ- 	meaning unclear, perhaps "pear-tree".
o 	ᛟ 	o 	/o(ː)/ 	*ōþila-/*ōþala- 	"heritage, estate, possession"
r 	ᚱ 	r 	/r/ 	*raidō 	"ride, journey"
s 	ᛊᛋ 	s 	/s/ 	*sōwilō 	"Sun"
t 	ᛏ 	t 	/t/ 	*tīwaz/*teiwaz 	"the god Tiwaz"
u 	ᚢ 	u 	/u(ː)/ 	*ūruz 	"aurochs"  *ûram "water/slag"
w 	ᚹ,ᚠ 	w 	/w/ 	*wunjō 	"joy"
x 	ᚷ 	g 	/ɡ/ 	*gebō 	"gift"
y 	ᛃ,ᛇ,ᛉ? 	y 	/j/ 	*jēra- 	"year,harvest"
z 	ᛋ 	z 	/z/ 	*algiz 	unclear, possibly "elk"
sh 	ᛊᛋ 	sh 	/s/ 	*sōwilō 	"Sun" soleil Solveig

ŋ ŋ ŋ 	ᛜ ᛝ 	ŋ 	/ŋ/ 	*ingwaz 	"the god Ingwaz"

small letters are *conjectures

 SINGLE PUNCTUATION	᛫
 MULTIPLE PUNCTUATION	᛬
 CROSS PUNCTUATION	᛭
 ARLAUG SYMBOL	ᛮ
 TVIMADUR SYMBOL	ᛯ
 BELGTHOR SYMBOL	ᛰ  ZHONG!


 FEHU FEOH FE F	ᚠ
 V	ᚡ
 URUZ UR Úr U	ᚢ
 YR	ᚣ
 Y	ᚤ
 W	ᚥ
 THURISAZ THURS THORN	ᚦ
 ETH	ᚧ
 ANSUZ A	ᚨ
 OS O	ᚩ
 AC A	ᚪ
 AESC	ᚫ
 LONG-BRANCH-OSS O	ᚬ
 SHORT-TWIG-OSS O	ᚭ
 O	ᚮ
 OE	ᚯ
 ON	ᚰ
 RAIDO RAD REID R	ᚱ
 KAUNA	ᚲ
 CEN	ᚳ
 KAUN K	ᚴ
 G	ᚵ
 ENG	ᚶ
 GEBO GYFU G	ᚷ
 GAR	ᚸ
 WUNJO WYNN W	ᚹ
 HAGLAZ H	ᚺ
 HAEGL H	ᚻ
 LONG-BRANCH-HAGALL H	ᚼ
 SHORT-TWIG-HAGALL H	ᚽ
 NAUDIZ NYD NAUD N	  ᚾ
 SHORT-TWIG-NAUD N  	ᚿ
 DOTTED-N      				ᛀ
 ISAZ IS ISS I	ᛁ
 E	ᛂ
 JERAN J	ᛃ
 GER	ᛄ
 LONG-BRANCH-AR AE	ᛅ
 SHORT-TWIG-AR A		ᛆ
 IWAZ EOH	ᛇ
 PERTHO PEORTH P	ᛈ
 ALGIZ EOLHX	ᛉ Zan:Live
 SOWILO S	ᛊ
 SIGEL LONG-BRANCH-SOL S	ᛋ
 SHORT-TWIG-SOL S	ᛌ
 C	ᛍ
 Z	ᛎ
 TIWAZ TIR TYR T	ᛏ
 SHORT-TWIG-TYR T	ᛐ
 D	ᛑ
 BERKANAN BEORC BJARKAN B	ᛒ
 SHORT-TWIG-BJARKAN B	ᛓ
 DOTTED-P	ᛔ
 OPEN-P	ᛕ
 EHWAZ EH E	ᛖ
 MANNAZ MAN M	ᛗ
 LONG-BRANCH-MADR M	ᛘ
 SHORT-TWIG-MADR M	ᛙ
 LAUKAZ LAGU LOGR L	ᛚ
 DOTTED-L	ᛛ
 INGWAZ	ᛜ
 ING	ᛝ
 DAGAZ DAEG D	ᛞ
 OTHALAN ETHEL O	ᛟ
 EAR	ᛠ
 IOR	ᛡ
 CWEORTH	ᛢ
 CALC	ᛣ
 CEALC	ᛤ
 STAN	ᛥ
 LONG-BRANCH-YR	ᛦ
 SHORT-TWIG-YR	ᛧ
 ICELANDIC-YR	ᛨ
 Q	ᛩ