Abissinia 		Abessinien 
Acheronte 		Acheron 
Achille 		Achilles 
Adamo 		Adam 
Adige 		Etsch 
Afghanistan 		Afghanistan 
Africa 		Afrika 
Alasca 		Alaska 
Albania 		Albanien 
Algeria 		Algerien 
Alpi 		Alpen 
Alsace 		Elsaß 
Alsazia 		Elsaß‐Lothringen 
Amburgo 		Hamburg 
America 		Amerika 
America 		Südamerika 
Anatolia 		Anatolien 
Ande 		Anden 
Andorra 		Andorra 
Angola 		Angola 
Annunciazone 		Mariä Verkündigung 
Antille 		Antillen 
Appennini 		Apenninen 
Aquisgrana 		Aachen 
Arabia 		Arabien 
Ardenne 		Ardennen Ardennerwald 
Argentina 		Argentinien 
Armenia 		Armenien 
Asia 		Asien 
Assiria 		Assyrien 
Atene 		Athen 
Atlantico 		Atlantischer Ozean 
Australia 		Australien 
Austria 		Österreich 
Azerbaigian 		Aserbaidschan 
Balcani 		Balkan 
Baltico 		Baltisches Meer Ostsee 
Befana 		Dreikönigsfest 
Belgio 		Belgien 
Berlino 		Berlin 
Bibbia 		Bibel 
Birmania 		Birma 
Borgogna 		Burgund 
Brasile 		Brasilien 
Bretagna 		Bretagne die Bretagne 
Cairo 		Kairo 
Canad 		Kanada 
Canarie 		Kanarische Inseln 
Capricorno 		Steinbock 
Castiglia 		Kastillien 
Cerbero 		Zerberus 
Cesare 		Cäsar 
Cile 		Chile 
Cina 		China 
Cipro 		Zypern 
Corano 		Koran 
Corea 		Korea 
Corsica 		Korsika 
Cristo 		Christus 
Croazia 		Kroatien 
Danimarca 		Dänemark 
Danubio 		Donau 
Dio 		Gott 
Egitto 		Ägypten 
Epifania 		Dreikönigsfest 
Etiopia 		Äthiopien 
Europa 		Europa 
Francia 		Frankreich 
Galles 		Wales 
Genova 		Genua 
Germania 		Deutschland 
Ginevra 		Genf 
Gran 		Britannien 
Grecia 		Griechenland 
Groenlandia 		Grönland 
IVA 		Mehrwehrtsteuer 
Iddio 		Gott 
India 		India Indien 
Indocina 		Hinterindien 
Inghilterra 		England 
Irlanda 		Irland 
Islam 		Islam 
Islanda 		Island 
Italia 		Italien 
Iugoslavia 		Jugoslawien 
Lapponia 		Lappland 
Lituania 		Litauen 
Londra 		London 
L 		Haag 
Mar 		Adria Adriatisches Meer 
Mar 		Ägäische Meer 
Messia 		Messias 
Milano 		Mailand 
Natale 		Weihnachten 
Norvegia 		Norwegen 
Ognissanti 		Allerheiligen 
Olanda 		Holland 
Olandese 		Holländer Niederländer 
Parigi 		Paris 
Pasqua 		Ostern 
Polonia 		Polen 
Portogallo 		Portugal 
Reno 		Rhein 
Roma 		Rom 
Russia 		Rußland 
Satana 		Satanas Teufel 
Scozia 		Schottland 
Sicilia 		Sizilien 
Spagna 		Spanien 
Stati 		Vereinigten Staaten 
Stoccolma 		Stockholm 
Svezia 		Schweden 
Svizzera 		Schweiz die Schweiz 
Ticino 		Tessin 
Turchia 		Türkei die Türkei 
Ungheria 		Ungarn 
Unione 		Europäische Union 
Venecia 		Venedig 
Venere 		Venus 
Vienna 		Wien 
Zurigo 		Zürich 
a 		an in nach zu 
abaco 		Abakus 
abate 		Abt 
abbandonare 		entäußern fortlassen überlassen unterlassen 
abbastanza 		genug genügend hinlänglich ziemlich 
abbonamento 		Abonnement 
abete 		Fichte Tanne 
abile 		begabt fähig imstande tüchtig 
abilit 		Kapazität 
abissino 		abessynisch 
abisso 		Abgrund Tiefe 
abitante 		Bewohner Einwohner Insasse 
abitare 		hausen wohnen 
abito 		Anzug Gewand Kostüm Tracht 
abortire 		abortieren 
accademia 		Akademie 
accadere 		geschehen passieren sich ereignen stattfinden vorkommen 
accanto 		neben 
accappatoio 		Bademantel 
accelerare 		beeilen beschleunigen fördern befördern 
accendere 		verbrennen 
accendino 		Funke 
accento 		Akzent Betonung Ton 
accettare 		annehmen empfangen genehmigen 
acciaio 		Stahl 
accidente 		Unfall 
acciuga 		Anchovis 
acclamare 		akklamieren zujauchzen 
accoglienza 		Annahme Aufnahme Übernahme Zusage 
accogliere 		annehmen empfangen genehmigen 
accoglimento 		Annahme Aufnahme Übernahme Zusage 
accomodamento 		Einrichtung Zusammenstellung 
accompagnare 		begleiten 
accordo 		Abkommen Einklang Übereinkommen Übereinkunft Übereinstimmung 
accorgersi 		gewahr werden inne werden 
accumulatore 		Akkumulator 
accusare 		anklagen beschuldigen 
aceto 		Essig 
acido 		herb sauer 
acino 		Traube Weintraube 
acqua 		Wasser 
acquaforte 		Scheidewasser 
aculeo 		Stachel 
acuto 		akut heftig hitzig 
adatto 		begabt fähig imstande tüchtig 
addio 		adieu auf Wiedersehen lebe wohl 
addormentarsi 		einschlafen 
adorare 		anbeten verehren vergöttern 
ad 		laut 
ad 		jäh 
aerare 		lüften 
aereo 		Äroplan Flugmaschine Flugzeug 
aeroplano 		Äroplan Flugmaschine Flugzeug 
aeroporto 		Flugplatz 
affare 		Angelegenheit Ding Sache Werk 
affascinante 		allerliebst anmutig hold lieblich reizend 
affaticare 		strapazieren 
affermare 		bejahen ja sagen 
afferrare 		greifen angreifen ergreifen 
affettazione 		Gezier 
affigere 		anlegen beifügen 
affilato 		scharf 
affisso 		Affiche Anschlag Anschlagzettel 
affittare 		vermieten 
affitto 		/m/-Miete;Vermietung/f/ 
afflitto 		düster 
affrancare 		frankieren 
affrancatura 		Frankatur Porto 
affrettarsi 		eilen sputen 
afgano 		afghanisch 
africano 		afrikanisch 
agente 		Agent Geschäftsbesorger 
agenzia 		Agentur 
aggettivo 		adjektivisch 
aggiungere 		addieren beifügen zufügen 
aggredire 		ein Anschlag ausführen ein Attentat ausführen 
agile 		behende gewandt 
agire 		agieren handeln verfahren vorgehen wirken 
agitato 		heftig unruhig 
agnello 		Lamm 
ago 		Nadel 
agonia 		Agonie Todeskampf 
agosto 		/m/-August/m/ 
agro 		herb sauer 
aia 		Dreschtenne Tenne 
aiutante 		Adjutant Hilfsoffizier 
aiutare 		assistieren beistehen helfen 
aiuto 		Beihilfe Beistand Handreichung 
ala 		Fittich Flügel 
alba 		Tagesanbruch 
albanese 		albanesisch albanisch 
albergo 		Hotel 
albero 		Baum 
albicocca 		Aprikose Marille 
album 		Album 
alcool 		Alkohol Spritus 
alcool 		Brennspiritus 
alcova 		Alkoven 
alfabet 		Alphabet 
alfabeto 		/m/-Alphabet/n/ 
algerino 		algerisch 
alice 		Anchovis 
alimentare 		beköstigen hegen nähren ernähren 
alimento 		Ätzung Ernährung Futter Nahrung Nahrungsmittel 
alito 		Atem Hauch 
allarme 		Alarm 
allattare 		säugen 
alla 		endlich 
allegria 		Jubel Wonne 
allegro 		fröhlich heiter lustig vergnügt 
allestire 		bereiten vorbereiten 
allievo 		Schüler 
allodola 		Lerche 
alloggio 		Wohnhaus Wohnung 
allora 		damals dann alsdann danach hierauf 
alloro 		Lorbeer Lorbeerbaum 
allo 		zugleich 
alludere 		anspielen anspielen auf 
allume 		Alaun 
all 		auswärtig 
all 		anfänglich 
almeno 		wenigstens 
alsaziano 		elsässisch 
altare 		Altar 
alta 		Flut 
alternativa 		Alternative 
altitudine 		Höhe 
alto 		erhaben hoch 
altro 		anderer anders sonst 
altrove 		anderswo 
altura 		Höhe 
alveare 		Bienenkorb Bienenstock 
alzare 		heben aufheben erheben zücken 
alzarsi 		aufstehen sich stellen 
amabile 		allerliebst anmutig hold lieblich reizend 
amare 		gern haben lieben mögen 
amaro 		bitter 
amazzone 		Amazone 
ambasciata 		Gesandtschaft 
ambasciatore 		Botschafter Gesandter 
ambiente 		/m/-Umgebung/f/ Milieu/n/ 
ambizione 		Ehrgeiz 
ambra 		Bernstein 
americano 		amerikanisch 
amianto 		Asbest 
amica 		Freundin 
amichevole 		freundlich 
amicizia 		/f/-Freundschaft/f/ 
amico 		Freund 
ammalarsi 		erkranken krank werden 
ammazzare 		ermorden töten 
amministrare 		administrieren verwalten 
amministratore 		Direktor Leiter Vorsteher 
amministrazione 		Verwaltung 
ammirabile 		bewundernswert wunderbar 
ammiraglio 		Admiral 
ammirare 		bewundern 
ammogliarsi 		sich verehelichen sich verheiraten 
ammonimento 		Ermahnung Zuspruch 
ammortizzare 		amortisieren löschen 
ammuffito 		moderig 
amnistia 		Amnestie Begnadigung Straferlaß 
amo 		Angelhaken 
ampolla 		Birne 
amputare 		abnehmen abschneiden amputieren 
analizzare 		analysieren auflösen zergliedern 
ananas 		Ananas 
ananasso 		Ananas 
anatema 		Bann Fluch Bannfluch 
anca 		Hanke Hüfte 
anche 		auch ebenfalls gleichfalls 
ancora 		noch 
andare 		fahren gehen treten 
andarsene 		abreisen fortgehen 
andatura 		Eile Geschwindigkeit Hast 
anello 		Ring 
anemia 		Blutarmut 
anemone 		Anemone 
angelo 		Engel 
angolo 		Ecke 
angoscia 		Angst 
angoscioso 		bang feige 
anguilla 		Aal 
animale 		/m/-Tier/n/ 
anitra 		Ente 
annegare 		ertränken 
annegarsi 		ersaufen ertrinken 
anno 		/m/-Jahr/n/ 
annoiare 		verdrießen 
anno 		Schaltjahr 
annuale 		/adv/jährlich 
annualmente 		alljährlich 
annullare 		annullieren für null und nichtig erklären kassieren 
annunciare 		ankündigen anzeigen avisieren melden anmelden verkünden 
annuncio 		Annonce Anzeige Inserat 
annunziare 		ankündigen anzeigen avisieren melden anmelden verkünden 
annunzio 		Auskunft Bekanntmachung 
antartico 		antarktisch südpolar 
antenato 		Ahn Vorfahr Urahn 
antenna 		Fühler Fühlhorn 
anticipare 		antizipieren vorausnehmen 
antico 		altertümlich antik 
antisettico 		antiseptisch fäulniswidrig 
antologia 		Anthologie 
antracite 		Anthrazit 
apatia 		Apathie Teilnahmslosigkeit 
ape 		/f/-Biene/f/ 
aperto 		offen 
apicoltura 		Bienenzucht 
apicultura 		Bienenzucht 
apoplessia 		Schlag Schlagfluß 
apostolo 		Apostel 
apparecchio 		Apparat Vorrichtung 
apparenza 		Anblick Aussehen 
apparire 		erscheinen 
appartamento 		/m/-Appartment/n/ Etagenwohnung/f/ Gemach/n/ 
appartenere 		gehören angehören zugehören 
appello 		Ruf 
appena 		kaum 
appetito 		Appetit 
appiccicare 		kleben leimen 
applaudire 		applaudieren Beifall spenden 
applausi 		Applaus Beifall 
applicare 		anwenden verwenden 
applicazione 		Fleiß 
appoggiare 		stemmen unterhalten unterstützen 
apposta 		absichtlich 
apprestare 		zurichten 
apprezzare 		abschätzen bewerten schätzen abschätzen einschätzen 
approfittare 		profitieren 
approvare 		approbieren billigen genehmigen gutheißen 
approvazione 		Approbation Beifall 
appuntamento 		Rendezvous 
appuntato 		spitz 
aprile 		/m/-April/m/ 
aprire 		aufmachen öffnen 
aquila 		Adler 
arabo 		arabisch 
aragosta 		Hummer 
arancia 		Apfelsine Orange Pomeranze 
arancio 		Orangenbaum 
aratro 		Pflug 
arbitrario 		beliebig eigenmächtig willkürlich 
arbusto 		Gebüsch Staude Strauch 
architetto 		Architekt 
arciduca 		Großherzog 
arcivescovo 		Erzbischof 
arco 		Bogen Bügel 
arcobaleno 		Regenbogen 
ardere 		brennen 
ardesia 		Schiefer Schiefergestein 
ardore 		Glut Feuer Inbrunst 
arena 		Arena Kampfplatz 
argentino 		Argentinier 
argento 		Silber 
argilla 		Lehm Ton Tonerde 
argomento 		Argument Beweis 
aria 		Luft 
arieggiare 		lüften 
aringa 		Hering 
armadio 		Schrank 
armare 		waffnen bewaffnen rüsten 
armeno 		armenisch 
arnese 		Mittel Werkzeug 
arnia 		Bienenkorb Bienenstock 
aroma 		Aroma Duft 
arrendersi 		sich ergeben kapitulieren 
arrestare 		arretieren festnehmen verhaften 
arrestato 		Arrestant 
arresto 		Arrest Haft 
arrischiare 		riskieren wagen 
arrivare 		erlangen erzielen reichen erreichen 
arrivo 		Ankunft Eintreffen 
arrugginito 		rostig 
arruolare 		werben anwerben 
arsenale 		Arsenal Zeughaus 
arteria 		Arterie Pulsader Schlagader 
articolo 		Abhandlung Artikel 
artiglieria 		Artillerie 
artiglio 		Klaue Kralle 
ascensore 		Aufzug Fahrstuhl Lift 
ascesso 		Abszeß Eiterbeule Geschwulst 
ascia 		Axt Beil Hacke 
asciugamano 		Handtuch 
ascoltare 		anhören horchen aushorchen zuhören 
asfalto 		Asphalt Erdpech 
asiatico 		asiatisch 
asilo 		Asyl Zufluchtsstätte 
asino 		/m/-Esel/m/ 
asma 		Asthma 
asparago 		Spargel 
aspettare 		gewärtigen harren warten erwarten 
aspetto 		Anblick Aussehen 
assai 		sehr 
assale 		Achse 
assalire 		ein Anschlag ausführen ein Attentat ausführen 
assalto 		Anfall Angriff 
asse 		Achse 
assediare 		belagern 
assedio 		Belagerung 
assegno 		Bankanweisung Scheck 
assegno 		Bankanweisung Scheck 
assente 		abwesend 
assenza 		Abwesenheit 
asserire 		behaupten 
assicurare 		behaupten bestätigen vergewissern 
assicurazione 		Assekuranz Versicherung 
assioma 		Axiom Grundsatz 
assiro 		assyrisch 
assistente 		Assistent 
assistere 		assistieren beistehen helfen 
asso 		As Dauß 
assurdo 		abgeschmackt absurd ungereimt widersinnig 
astratto 		abstrakt begrifflich unwirklich 
ateniese 		athenisch 
atlantico 		Atlantik‐ 
atmosfera 		Atmosphäre 
atomo 		Atom 
attaccare 		anfallen angreifen ausfallen befallen überfallen 
attacco 		Anfall Angriff 
attendere 		achtgeben aufpassen beachten zusehen 
attentato 		Anschlag Attentat 
attento 		aufmerksam 
attenzione 		Achtung Aufmerksamkeit 
attirare 		anziehen 
attivo 		aktiv tätig 
attore 		Schauspieler 
attraversare 		entern übergeben übertreten 
attraverso 		hindurch quer mitten 
attuale 		aktuell gegenwärtig 
augurio 		Anzeichen Vorzeichen 
australiano 		australisch 
austriaco 		österreichisch 
autista 		Chauffeur Fahrer 
auto 		Auto 
autobus 		Autobus Bus 
autocarro 		Lastauto Lastkraftwagen LKW 
autocrate 		Autokrat Selbstherrscher 
automa 		Automat 
automobile 		Auto 
autore 		Autor Urheber Verfasser 
autorimessa 		Garage 
autorit 		Autorität Gewalt 
autunale 		Herbst- herbstlich 
autunno 		/m/-Herbst/m/ 
avambraccio 		Unterarm 
avanti 		hervor vorwärts 
avaro 		geizig 
avena 		Hafer 
avere 		besitzen haben innehaben 
aver 		benötigen brauchen nötig haben 
aver 		fürchten befürchten sich ängsten sich ängstigen zagen 
aviazione 		Aviatik 
avido 		begierig habgierig lüstern 
avvelenare 		vergiften 
avvenire 		Futur Futurum Zukunft 
avventura 		Abenteuer 
avverbio 		Adverb Umstandswort 
avversione 		Abneigung Antipathie Wiederwillen 
avvertire 		warnen 
avviso 		Annonce Anzeige Inserat 
avvolgere 		packen einpacken 
azione 		Handlung Tat 
azionista 		Aktieninhaber Aktionär 
azzurro 		blau 
a 		billig 
a 		heim daheim zu Hause 
a 		rechts 
a 		lange 
a 		auswendig aus dem Kopfe 
a 		links 
a 		Glückwünsch 
babordo 		Backbord 
bacca 		Beere 
bacca 		Blaubeere Heidelbeere 
baciare 		küssen 
bacillo 		Bazillus 
bacino 		Becken Schale 
bacio 		Kuß 
badare 		beaufsichtigen warten 
badia 		Abtei 
baffi 		Schnurrbart 
bagagliaio 		Gepäckwagen 
bagaglio 		Bagage Gepäck Verpackung 
bagassa 		Bagasse 
bagnante 		Badegast 
bagnare 		baden 
bagnato 		naß 
bagni 		Badeort 
bagno 		Bad 
baia 		Bai Bucht 
baionetta 		Bajonett 
balcone 		Altan Balkon 
balena 		/f/-Wal/m/ 
baleno 		Blitz 
ballare 		tanzen 
ballata 		Ballade 
ballo 		Ball 
baluardo 		Bastei Bastion Bollwerk 
bambino 		Kind 
bambola 		Puppe 
bamb 		Bambus 
banale 		abgedroschen banal fade 
banana 		Banane 
banca 		Bank 
banchiere 		Bankier 
banconota 		Bon Schein 
banda 		Allianz Band Bund Bündnis Liga Verband Verbindung 
bandiera 		Banner Fahne Flagge 
bandire 		bannen ins Exil schicken verbannen 
bandito 		Bandit Räuber 
bar 		Büfett Schankraum 
baracca 		Baracke Lagerhütte 
barba 		Bart 
barbabietola 		Beete Mangold Runkelrübe 
barbaforte 		Krehn Meerrettich 
barbaro 		Barbar 
barbiere 		Barbier 
barca 		Boot 
barile 		Faß Tonne 
barometro 		Barometer 
barone 		Baron Freiherr 
barra 		Barre Stange 
barriera 		Barriere Schranke 
bassa 		Ebbe 
basso 		niedrig 
bastardo 		Bastard Mischling 
bastare 		ausreichen genügen hinreichen zureichen 
bastione 		Bastei Bastion Bollwerk 
battaglia 		Kampf Schlacht 
battaglione 		Bataillon 
battere 		hauen schlagen 
battere 		applaudieren Beifall spenden 
batteria 		Batterie 
batterio 		Bakterie 
battesimo 		Taufe 
battezzare 		taufen 
baule 		Koffer 
bazar 		Basar Markt Warenhaus 
becco 		Schnabel 
belga 		Belgier 
bellino 		hübsch 
bello 		hübsch schön 
benche 		obgleich obschon wenn auch zwar 
beneficio 		Ertrag Gewinn Interesse Nutzen Überschuß Verdienst Vorteil 
benevole 		freundlich 
benzina 		Benzin 
bere 		trinken 
beretta 		Barett 
bestemmiare 		lästern 
bestia 		/f/-Bestie/f/ Tier/m/ 
betulla 		Birke 
bevanda 		Getränk Trank 
bianco 		weiß 
bibita 		Getränk Trank 
biblioteca 		Bibliothek 
bibliotecario 		Bibliothekar 
bicchiere 		Glas 
bicicletta 		Fahrrad Rad Rover 
bigio 		grau 
biglietto 		Billett Fahrkarte Karte 
bilancia 		Waage 
bilancio 		Bilanz Schlußrechnung 
bile 		Galle 
biliardo 		Billard 
biondo 		blond 
birra 		Bier 
birraio 		Brauer 
birreria 		Brauerei 
bisbigliare 		flüstern 
biscotto 		Biskuit Bisquit Zwieback 
bisnonno 		Urahn Urgroßvater 
bisogno 		Bedarf Bedürfnis 
bistecca 		Beefsteak 
bloccare 		blockieren 
blocco 		Block Klotz 
blu 		blau 
blusa 		Bluse 
bocca 		Mund 
boccale 		Becher Pokal 
boia 		Henker 
bollire 		brausen kochen sieden wallen 
bollo 		Briefmarke 
bomba 		Bombe 
bomba 		Brandbombe 
bosco 		Forst Wald 
bottiglia 		Flasche 
bracchio 		Arm 
braccialetto 		Armband 
bramoso 		begierig habgierig lüstern 
branchia 		Kieme 
brasiliano 		Brasilianer 
breve 		bündig gedrängt konzis kurz 
brigante 		Bandit Räuber 
brigata 		Abteilung Detachement 
brillante 		blank 
brillare 		blinken glänzen scheinen schimmern strahlen 
brillo 		berauscht trunken betrunken 
brocca 		Kanne Krug 
bronzo 		Bronze Erz 
bruciare 		verbrennen 
bruco 		Raupe 
bruno 		braun 
brusco 		brummig unwirsch 
buca 		Briefkasten 
buco 		Loch 
bue 		Ochs 
bufalo 		Büffel 
buio 		dunkel düster trübe 
buono 		gut gütig 
burro 		Butter 
burrone 		Abgrund Tiefe 
bussola 		Kompaß 
busta 		Briefumschlag Kuvert Umschlag 
busto 		Büste 
cabina 		Kabine Kajüte Koje 
cacao 		Kakao 
cacciare 		jagen 
cacto 		Kaktus 
cadetto 		Kadett 
caff 		Kaffee 
cagna 		/f/-Hündin 
calce 		Kalk 
calcestruzzo 		Beton 
calcolare 		erachten kalkulieren rechnen berechnen 
calderotto 		Kessel 
caldo 		warm 
calice 		Becher Pokal 
callo 		Hühnerauge Leichdorn Schwiele 
calmare 		besänftigen dämpfen züchtigen 
calmo 		gelassen gemütlich ruhig still 
calunniare 		afterreden anschwärzen fälschlich beschuldigen verleumden 
calvo 		kahl 
calzolaio 		Schuhmacher Schuster 
calzoni 		Beinkleid Hose 
cambiale 		Wechsel 
cambiamento 		Veränderung 
cambiare 		ändern tauschen umändern umtauschen wechseln umwechseln 
camera 		Gemach Stube Zimmer 
camera 		Schlafzimmer 
cameriera 		/f/-Zimmermädchen/n/ Zofe/f/ 
cameriere 		Kellner 
camion 		Lastauto Lastkraftwagen LKW 
camminare 		fahren gehen treten 
cammino 		Bahn Chaussee Strecke Weg 
campagna 		Gefilde Land 
campana 		Glocke Klingel 
campione 		Muster Probe Probestück Spezimen 
campo 		Acker 
camposanto 		Friedhof Gottesacker Kirchhof 
candela 		Kerze Licht 
cane 		/m/-Hund/m/ 
canna 		Angelrute 
cantante 		Berufssänger Kantor Sänger 
cantare 		singen 
canzone 		Gesang Lied 
capace 		begabt fähig imstande tüchtig 
capacit 		Kapazität 
capanna 		Hütte 
capelli 		Haar Haare 
capire 		begreifen erfassen verstehen 
capitano 		Hauptmann Kapitän 
capo 		Befehlshaber Chef Haupt Häupling Herr Oberhaupt Vorsteher 
capostazione 		Bahnhofsvorsteher 
capotreno 		Aufseher Führer Kondukteur Schaffner 
capoverso 		Absatz Alinea 
capo 		Neujahr 
cappotta 		Haube Kapotte 
capra 		Geiß Ziege Zicke 
capriolo 		/m/-Reh/n/ 
capro 		Ziegenbock 
carattere 		Natur 
carbone 		Kohle 
carciofo 		Artischocke 
caricare 		anklagen beschuldigen 
carico 		Belastung Bürde Fuhre Ladung Last 
carino 		freundlich 
carnagione 		Gesichtsfarbe Teint 
carne 		Fleisch 
carne 		Hammelfleisch 
carne 		Kalbfleisch 
caro 		hold lieb 
carota 		Karotte Möhre Mohrrübe 
carriera 		/f/-Karriere/f/ 
carta 		Karte Zettel 
carta 		Löschpapier 
carta 		Löschpapier 
carta 		Toilettenpapier 
cartellone 		Affiche Anschlag Anschlagzettel 
cartolina 		Postkarte 
casa 		Haus 
cascata 		Wasserfall 
casella 		Postfach 
caserma 		Kaserne 
caso 		Hasard Zufall 
cassa 		Behälter Besteck Krug 
cassa 		Sarg 
casseruola 		Bratpfanne Kasserole Kochpfanne Pfanne 
cassetto 		Lade Schublade Tischlade 
castagna 		Kastanie 
castagno 		Kastanienbaum 
castello 		Burg Kastell Schloß 
castigare 		ahnden strafen bestrafen züchtigen 
catalogo 		Katalog Verzeichnis 
catedrale 		Dom Kathedrale Münster 
catena 		Kette 
catrame 		Teer 
cattivo 		böse schlecht 
causa 		Anlaß Grund Ursache Veranlassung 
causare 		antun bewirken veranlassen verursachen zufügen 
cava 		/f/-Grube/f/;Steinbruch/m/ 
cavalletta 		Grashüpfer Heuschrecke 
cavallo 		Gaul Pferd 
cavatappi 		Korkenzieher 
cavia 		/f/-Meerschweinchen;Versuchskaninchen/n/ 
caviglia 		Knöchel 
cavo 		Kabel 
cavolfiore 		Blumenkohl Karfiol 
cavolo 		Kohl 
cecita 		Blindheit 
cedere 		abtreten nachgeben weichen 
cedola 		Coupon Zinsabschnitt 
celebre 		berühmt 
cella 		/f/-Zelle/f/ 
cena 		Abendessen Abendmahl Souper 
cenere 		Asche 
censore 		Zensor 
censura 		Zensur 
centesimo 		Cent 
centimetro 		Centimeter Zentimeter 
cento 		hundert 
centrale 		zentral 
centro 		Mittelpunkt Zentrum 
cercare 		ausschauen nach suchen aufsuchen 
cerchio 		Zirkel 
certamente 		allerdings bestimmt freilich gewiß immerhin wohl zwar 
certificato 		Attest Testimonium Zeugnis Zertifikat 
certo 		bestimmt gewiß sicher zuversichtlich 
cervello 		Gehirn Hirn 
cervo 		/m/-Hirsch/m/ 
cessare 		aufhören 
cessione 		Zession 
cesso 		Abort Abtritt 
cestino 		Papierkorb 
cesto 		Korb 
che 		daß 
chiacchierare 		plaudern schwatzen 
chiamare 		heißen nennen benennen ernennen 
chiamarsi 		heißen 
chiamata 		Anruf Zuruf 
chiaro 		anschaulig augenscheinlich ersichtlich evident offenbar 
chiave 		Schlüssel 
chicco 		Traube Weintraube 
chiedere 		bitten ersuchen 
chiesa 		Kirche 
chiglia 		Kiel 
chimica 		Chemie 
chiocciola 		Schnecke 
chiocciolina 		Klammeraffe 
chiodo 		Nagel Stift 
chirurgo 		Chirurg Wundarzt 
chiudere 		schließen verschließen zumachen 
chiuso 		geschlossen zu 
cibo 		Ätzung Ernährung Futter Nahrung Nahrungsmittel 
ciclomotore 		Moped 
cieco 		blind 
cielo 		Himmel 
ciliegia 		Kirsche 
ciliegio 		Kirschbaum 
cilindro 		Walze Zylinder 
cima 		First Gipfel Wipfel 
cimice 		/f/-Wanze/f/ 
cimitero 		Friedhof Gottesacker Kirchhof 
cinema 		Kino 
cinese 		Chinese 
cinghiale 		/m/-Wildschwein/n/ Eber/m/ 
cinquanta 		fünfzig 
cinque 		fünf 
cintura 		Gurt Gürtel 
cioccolata 		Schokolade 
cio 		das heißt das ist 
cipolla 		Zwiebel 
cipollina 		Schnittlauch 
cipresso 		Zypresse 
circa 		annähernd etwa ungefähr 
circo 		Zirkus 
circolo 		Zirkel 
circondare 		umringen umzingeln 
circondario 		Amtsbezirk Bezirk Distrikt Gau 
citare 		anführen erwähnen nennen zitieren 
citazione 		Zitat 
cittadella 		Zitadelle 
cittadinanza 		Staatsangehörigkeit 
citt 		Ort Stadt 
ciuco 		Esel 
civile 		bürgerlich zivil 
cliente 		Klient Kunde 
clima 		Klima 
cloro 		Chlor 
coccodrillo 		Krokodil 
coda 		Bürzel Fahne Lunte Rute Schleppe Schwanz Schweif Sterz Wedel 
cognac 		Kognak 
cognato 		Schwager 
cognome 		Familienname 
coincidenza 		Anschluß 
colazione 		Frühstück 
colle 		Halde Hügel 
collega 		Kollegium 
collegio 		Amtsbruder Amtsgenosse Genosse Kollege 
collina 		Halde Hügel 
collo 		Hals 
colore 		Farbe 
colpevole 		schuldig 
colpire 		klopfen schlagen 
colpo 		Hieb Schlag Streich 
coltello 		Messer 
comandante 		Befehlshaber 
comando 		Befehl 
come 		als ob gleichsam 
comico 		drollig komisch spaßhaft 
cominciare 		anbrechen anfangen beginnen 
comitato 		Ausschuß Komitee 
commedia 		Komödie Lustspiel 
commerciante 		Händler Kaufmann 
commercio 		Handel 
commestibile 		eßbar genießbar 
commettere 		anfertigen herstellen leiten machen tun zurücklegen 
commissario 		Kommissar 
comodo 		bequem gemächlich wohnlich 
compagnia 		Gesellschaft Kompagnie 
compare 		Gevatter Pate 
comperare 		kaufen sichkaufen 
compiere 		ausführen bestellen erfüllen leisten 
compito 		Arbeit Aufgabe Pensum 
compleanno 		Jahrestag 
completamente 		völlig 
completare 		vervollständigen 
completo 		ganz total 
comportarsi 		sich aufführen sich benehmen sich betragen sich verhalten 
comprare 		kaufen sichkaufen 
compratore 		Klient Kunde 
comprendere 		begreifen erfassen verstehen 
comprensibile 		begreiflich faßbar verständlich 
compromesso 		Kompromiß 
comune 		gemein allgemein gemeinsam gemeinschaftlich 
comunicare 		anschließen mitteilen teilhaftig machen verbinden 
comunicato 		Auskunft Bekanntmachung 
comunista 		Kommunist 
concernere 		betreffs 
concerto 		Musikaufführung Konzert 
conchiglia 		Muschel 
concimare 		düngen 
conciso 		bündig gedrängt konzis kurz 
concludere 		ableiten deduzieren folgern 
concordare 		beipflichten beistimmen einwilligen zustimmen zuwilligen 
concorso 		Konkurrenz‐Prüfung Preisausschreiben Wettbewerb 
condannare 		verdammen verurteilen 
condotta 		Aufführung Benehmen Betragen Gebahren Verhalten 
condotto 		Rohr Röhre Schlauch 
condurre 		führen leiten lenken 
condursi 		sich aufführen sich benehmen sich betragen sich verhalten 
conferenza 		Beratung Konferenz 
confermare 		bekräftigen bestätigen konfirmieren 
confessare 		anerkennen gestehen eingestehen 
confessione 		Bekenntnis Eingeständnis Geständnis 
confetto 		Bonbon 
confine 		Grenze Schranke 
conflitto 		Konflikt Streit Widerstreit 
confrontare 		vergleichen 
confuso 		bestürtzt 
congedo 		Abschied Valet 
congelarsi 		erfrieren 
congiungere 		fügen gesellen vereinigen 
congiunto 		verwandt anverwandt 
congresso 		Kongreß 
coniglio 		Kaninchen 
coniugi 		Ehepaar 
conoscenza 		Bekannter 
conoscere 		kennen 
conosciuto 		bekannt 
consapevolezza 		Bewußtsein 
conservare 		aufbewahren behalten bergen erhalten konservieren 
conservatorio 		Konservatorium 
considerare 		berücksichtigen betrachten erwägen sich überlegen 
considerato 		da denn weil 
considerazione 		Achtung Verehrung 
consigliare 		raten beraten ratgeben 
consiglio 		Rat Ratschlag 
consolare 		trösten Trost spenden 
consolato 		Konsulat 
console 		Konsul 
consorti 		Ehepaar 
constatare 		als Tatsache feststellen konstatieren 
consueto 		geläufig üblich 
contabile 		Buchhalter 
contadino 		Bauer 
contante 		bar kontant 
contare 		zählen aufzählen 
contatto 		Berührung Kontakt 
contenere 		enthalten 
contento 		zufrieden 
contenuto 		Inhalt 
continuare 		fortfahren fortführen 
continuo 		fest 
conto 		Kalkul 
contraddire 		widersprechen 
contrasto 		Gegensatz Kontrast 
contratto 		Akkord Traktat Vertrag 
contravvenzione 		Geldstrafe 
contributo 		Beisteuer Kontribution 
contribuzione 		Abgabe Steuer Steuerabgabe 
contro 		an gegen gegenüber wider 
controllare 		kontrollieren nachsehen überwachen 
convegno 		Versammlung Zusammenkunft 
conveniente 		angemessen füglich geeignet zeitgemäß 
convenire 		gehören schicken sich gehören ziemen 
conversazione 		Gespräch Konversation Unterhaltung 
convertire 		bekehren umstimmen 
convertito 		Proselyt 
convincere 		überreden überzeugen 
coperta 		Deck Schiffsdeck Verdeck 
coprire 		belegen decken bedecken einhüllen verhüllen zudecken 
coraggio 		Mut 
cornamusa 		Dudelsack 
corpo 		Körper Leib 
correggere 		berichtigen korrigieren verbessern 
corrente 		Strömung 
correre 		laufen 
corretto 		recht richtig 
corridoio 		Gang Hausflur Flur Korridor 
corsia 		Bahn Chaussee Strecke Weg 
corteccia 		Baumrinde Rinde 
cortese 		freundlich 
cortile 		Hof Hofraum 
cortina 		Gardine Vorhang 
corto 		kurz 
corvo 		Rabe 
cosa 		Ding 
coscia 		Schenkel Oberschenkel 
cosciente 		wissentlich 
coscienza 		Bewußtsein 
costa 		Küste 
costante 		beständig fest konstant ständig stetig unablässig 
costare 		kosten 
costoletta 		Kotelett 
costoso 		teuer wert 
costringere 		zwingen 
costruire 		bauen aufbauen erbauen konstruieren 
costruzione 		Erbauung Bau 
costume 		Anzug Gewand Kostüm Tracht 
costume 		Badeanzug 
covare 		brüten 
covata 		Brut 
cranio 		Schädel 
cravatta 		Halsbinde Krawatte Schlips 
credere 		glauben 
credito 		Kredit 
creditore 		Gläubiger Kreditor 
crema 		Rahm Sahne 
crepa 		Spalte 
crepuscolo 		Zwielicht 
crescere 		gedeihen wachsen anwachsen 
crescimento 		Anwuchs Vermehrung Wuchs Zunahme 
creta 		Kreide 
cricco 		Heber 
criceto 		/m/-Hamster/m/ 
crisi 		Krisis Krise 
criticare 		begutachten kritisieren 
croce 		Kreuz 
crudele 		grausam 
crudo 		arg rauh roh 
cubo 		Würfel 
cucchiaio 		Löffel 
cucina 		Küche 
cugina 		Base Kusine 
cugino 		Cousin Vetter 
cuoca 		Köchin 
cuocere 		backen 
cuoio 		Leder 
cuore 		Gemüt Herz 
cura 		/f/-Sorge;Pflege;Sorgfalt/f/ 
curare 		pflegen warten 
curato 		Geistliche Pastor Pfarrer Priester 
curioso 		neugierig 
curva 		Kurve 
curvarsi 		hängen sich bücken 
curvo 		gebogen krumm 
cuscino 		Kissen 
dabbasso 		unten unterhalb 
dado 		Würfel 
danese 		Däne 
danneggiare 		beschädigen Schaden zufügen verderben verletzen 
danza 		Tanz 
dappertutto 		allenthalben allerorten überall 
dapprima 		anfänglich 
dapprincipio 		anfänglich 
dare 		erteilen geben angeben herreichen 
data 		Datum 
dattero 		Dattel 
davanti 		früher zuvor 
davvero 		fürwahr wahrhaftig wahrlich wirklich 
dazio 		Akzise Verbrauchssteuer 
da 		lange 
debilitare 		erschlaffen 
debito 		Ausstand Schuld 
debole 		flau gelinde schwach 
decente 		gehörig 
decidere 		beschließen entscheiden sich entschließen 
decimetro 		Dezimeter 
decisione 		Austrag Beschluß Entschluß 
decisivo 		entschieden 
decorare 		aufputzen ausputzen schmücken verzieren 
decrepito 		abgelebt baufällig gebrechlich hinfällig 
decreto 		Dekret 
dedurre 		ableiten deduzieren folgern 
definire 		bestimmen definieren 
definitivo 		definitiv endgültig 
delegato 		Abgeordneter Delegierter 
delfino 		Delphin Tümmler 
delicato 		delikat fein gelinde zart 
delitto 		Frevel Verbrechen Vergehen 
demonio 		Teufel 
denaro 		Geld 
denso 		dicht gedrängt geschlossen 
dentatura 		Gebiß 
denti 		Gebiß 
dentista 		Zahnarzt 
dentro 		in nach pro zu 
denuncia 		Anzeige 
denunciare 		angeben anzeigen denunzieren hinterbringen 
depresso 		flau träge 
deputato 		Abgeordneter Delegierter 
derivare 		ableiten herleiten 
derubare 		berauben 
descrivere 		beschreiben 
deserto 		Einöde Wildnis Wüste 
desiderabile 		erwünscht 
desiderare 		wünschen 
desiderio 		Begehr Lust Wunsch 
despota 		Gewaltherrscher Despot 
dessert 		Dessert Nachtisch 
destinare 		ausersehen bestimmen festsetzen 
destinario 		Empfänger 
destra 		Steuerbord 
destrezza 		Geschicklichkeit Gewandtheit 
destro 		rechter 
detenuto 		Arrestant 
detestare 		verabscheuen 
di 		ab seit von 
diabolico 		teuflisch 
diadema 		Diadem 
dialetto 		Dialekt Mundart 
diamante 		Diamant 
diario 		Tagebuch 
diavolo 		Teufel 
dicembre 		/m/-Dezember/m/ 
dichiarazione 		Angabe Anzeige 
diciannove 		neunzehn 
diciasette 		siebzehn 
diciotto 		achtzehn 
dieci 		zehn 
dieta 		Diät 
dietro 		hinter 
difendere 		behaupten beschützen verteidigen 
difesa 		Abwehr Wehr 
difetto 		Verderbnis 
differente 		verschieden verschiedenartig 
difficile 		schwer 
dilettante 		Amateur Liebhaber 
diligenza 		Fleiß 
dimensione 		Ausdehnung Dimension 
dimenticare 		vergessen 
dimorare 		hausen wohnen 
dinamite 		Dynamit 
dio 		Gott 
dipendente 		abhängig 
dipendere 		abhängen 
dipingere 		malen 
diploma 		Diplom Prüfungszeugnis Urkunde 
diplomatico 		Diplomat 
dire 		erwähnen sagen 
direttamente 		gleich sogleich 
direttore 		Direktor Leiter Vorsteher 
direzione 		Verwaltung 
dirigere 		administrieren verwalten 
diritto 		Befugnis Recht 
disastro 		Ungemach Unglück 
discendente 		Abkomme Abkömmling Epigone 
discendenza 		Abkunft Abstammung Herkunft Ursprung 
discendere 		entspringen entstehen herkommen stammen abstammen 
discreto 		diskret verschwiegen 
discutere 		diskutieren erörtern verhandeln 
disegnare 		zeichnen abzeichnen 
disegno 		Zeichnung 
disfatta 		Niederlage 
disgrazia 		Unfall 
disonesto 		unredlich 
disporre 		disponieren verfügen walten 
disposto 		geneigt zu 
dissoluto 		unbändig zügellos 
distante 		entlegen fern entfernt weit 
distanza 		Abstand Entfernung Weite 
distillare 		destillieren 
distinguere 		auszeichnen hervorheben unterscheiden 
distinto 		anschaulich bestimmt deutlich klar 
distretto 		Amtsbezirk Bezirk Distrikt Gau 
distribuire 		austeilen verallgemeinern verteilen 
distruggere 		umreißen vernichten zerstören 
disturbare 		beengen behindern belästigen genieren lästig fallen stören 
dito 		Finger 
dito 		Zehe 
ditta 		/f/-Firma/f/ 
diversamente 		andernfalls anders sonst 
divertire 		amüsieren belustigen ergötzen unterhalten 
dividere 		dividieren teilen einteilen gliedern verteilen zerlegen 
divisione 		Sektion 
divorzio 		Scheidung 
dizionario 		Wörterbuch 
di 		früh zeitig 
di 		hinten 
di 		freilich tatsächlich 
di 		ihre 
di 		daher 
di 		insgeheim verstohlen 
di 		abermalig abermals von neuem wieder 
di 		allerlei 
di 		dann und wann von Zeit zu Zeit zeitweilig 
di 		abends 
di 		oben 
doccia 		Brause Dusche Sturzbad 
documento 		Dokument Urkunde 
dodici 		zwölf 
dogana 		Zollamt 
dolce 		süß 
dolore 		Schmerz Weh 
domanda 		/f/-Gesuch/m/ 
domandare 		fragen anfragen 
domani 		morgen 
domenica 		/f/-Sonntag/m/ 
domestica 		/f/-Dienstmädchen/n/ 
domestico 		Hausdiener 
dominare 		herrschen beherrschen regieren 
donna 		Frau Weib 
dono 		Angebinde Gabe Geschenk Spende Vermächtnis 
dopo 		hinter 
dopodomani 		übermorgen 
doppio 		doppelt zweifach 
dormire 		schlafen 
dorso 		Rücken 
dose 		Dosis 
dotato 		begabt 
dote 		Dotation Mitgift 
dottore 		Doktor 
dovere 		Gebühr 
drago 		Drache 
dragone 		Drache 
dubbioso 		fraglich 
dubitare 		zweifeln bezweifeln 
due 		zwei 
duellare 		sich duellieren 
duetto 		Duett 
duna 		Düne 
duomo 		Dom Kathedrale Münster 
dura 		hart 
durante 		während 
durare 		dauern währen 
durata 		Dauer Weile 
durevole 		fest 
duro 		hart 
d 		andernteils 
ecc 		u.s.w. 
eccetto 		ausgenommen 
ecclesiastico 		Geistliche 
economia 		/f/-Wirtschaft/f/ 
edificio 		Bau Bauwerk Gebäude 
edizione 		Abendzeitung 
efficace 		drastisch zweckdienlich 
eguaglianza 		Gleichheit 
eguale 		egal gleich 
elefante 		/m/-Elefant/m/ 
elegante 		elegant geschmackvoll 
eleggere 		auslesen wählen auswählen erwählen 
elemento 		Element 
elemosina 		Almosen 
elettricit 		Elektrizität 
elica 		Schneckenlinie Schraube 
energico 		forsch tüchtig 
entrare 		eintreten 
entrata 		Eingang 
entusiasmo 		Begeisterung Enthusiasmus 
epopea 		Epik Epopöe Heldengedicht 
equatore 		Äquator 
equilibrio 		Gleichgewicht 
equipaggio 		Mannschaft 
erba 		Gras 
ereditare 		erben beerben 
erpice 		Egge 
errare 		sich irren 
errore 		Fehler Irrtum Versehen 
esame 		Examen 
esaminare 		examinieren inspizieren nachsehen prüfen untersuchen 
esatto 		akkurat genau 
esca 		Köder 
eseguire 		ausführen bestellen erfüllen leisten 
esempio 		Beispiel Exempel 
esercito 		Armee Heer 
esercizio 		Exerzitium Übung 
esiliare 		bannen ins Exil schicken verbannen 
esilio 		Acht Exil Verbannung 
esistenza 		Bestehen Dasein Existenz 
esistere 		bestehen da sein existieren vorhanden sein 
esitare 		schwanken zaudern zögern 
esito 		Erfolg Ergebnis Resultat 
esortazione 		Ermahnung Zuspruch 
esportazione 		Ausfuhr Export 
esposizione 		Ausstellung 
esserer 		beipflichten beistimmen einwilligen zustimmen zuwilligen 
essere 		sitzen 
essere 		dienen frommen nützen 
est 		Orient Osten 
estate 		/f/-Sommer/m/ 
esteriore 		Äußere Habitus 
estero 		Ausland 
estivo 		Sommer- sommerlich 
estorcere 		erzwingen 
estremamente 		meist am meisten 
estremo 		äußerster extrem 
eterno 		ewig 
etichetta 		Etikette 
et 		Alter 
europeo 		Europäer 
evidente 		anschaulig augenscheinlich ersichtlich evident offenbar 
evidentemente 		offenbar 
evitare 		ausweichen entgegen entweichen meiden vermeiden 
fabbisogno 		Bedarf Bedürfnis 
fabbrica 		Fabrik 
fabbricare 		anfertigen fabrizieren herstellen verfertigen 
faccenda 		Angelegenheit Ding Sache Werk 
facchino 		Dienstmann Gepäckträger Träger 
faccia 		Angesicht Antlitz Gesicht 
facile 		geläufig leicht mühelos nicht schwierig 
faggio 		Buche 
fagiano 		Fasan 
fagiolo 		Faseole 
fagiuolo 		Faseole 
falce 		Hippe Sense 
fallimento 		Bankerott Fallissement Fallit 
falso 		falsch 
famiglia 		Familie 
famoso 		berühmt 
fanatico 		fanatisch leidenschaftlich 
fango 		Dreck Kot Schlamm Schmutz 
fantasia 		Einbildungskraft Phantasie 
farafalla 		/f/-Schmetterling/m/ 
fare 		anfertigen herstellen leiten machen tun zurücklegen 
fare 		boxen 
fare 		streiken 
farfalla 		Falter Schmetterling 
farmacia 		Apotheke 
farmacista 		Apotheker 
faro 		Leuchtturm 
far 		barbieren rasieren 
far 		Schmerz verursachen schmerzen wehe tun 
fascicolo 		Heft 
fascino 		Anmut 
fata 		Fee 
fatto 		Tatsache 
fattoria 		Bauernhof Besitzung Gut Landgut 
fattura 		Faktura Rechnung Warenrechnung 
fava 		Bohne 
favola 		Märchen 
favorire 		begünstigen 
febbraio 		/m/-Februar/m/ 
febbre 		Fieber 
fecondo 		fruchtbar 
fedele 		gläubig treu 
fegato 		Leber 
felice 		glücklig 
felicitare 		beglückwünschen gratulieren 
fendere 		spalten 
ferire 		verletzen verwunden 
ferita 		Verwundung Verletzung Wunde 
fermare 		anhalten bremsen sperren 
fermarsi 		halten anhalten Halt machen stocken stoppen 
fermata 		Haltestelle 
fermo 		fest fix 
ferro 		Eisen 
ferrovia 		Bahn Eisenbahn 
ferro 		Bügeleisen 
fessura 		Spalte 
festa 		Feier Fest 
fiaba 		Märchen 
fiaccola 		Fackel 
fiamma 		Flamme 
fiammifero 		Streichholz Zündholz 
fianciullo 		Kind 
fianco 		Flanke Seite 
fico 		Feigenbaum 
fidanzata 		Braut 
fiducia 		Zuversicht 
fieno 		Heu 
fiero 		hochfahrend hochmütig stolz 
figlia 		Tochter 
figlio 		Sohn 
figliola 		Tochter 
figliolo 		Sohn 
figliuola 		Tochter 
figura 		Abbild Figur Gestalt 
figurarsi 		erdichten sich einbilden sich vorstellen 
film 		Film 
filo 		Draht 
filosofo 		Denker Philosoph Vernunftforscher 
finalmente 		endlich 
fine 		Ende 
finestra 		Fenster 
finire 		beschließen enden beenden endigen beendigen erledigen 
finito 		fertig 
fiore 		Blume 
fiore 		Mehl 
fiorire 		blühen 
firma 		Unterschrift 
firmare 		subskribieren 
fisarmonica 		Ziehharmonika 
fischiare 		pfeifen 
fissare 		befestigen festsetzen fixieren 
fiume 		Fluß 
flanella 		Flanell 
flauto 		Flöte 
fluire 		fließen rinnen strömen 
foca 		/f/-Seehund/m/ 
foco 		Brennpunkt Fokus 
foglia 		Blatt 
foglio 		Blatt 
folla 		Haufen Menge Stapel 
follia 		Torheit 
fondamento 		Fundament Grundlage 
fondere 		fundieren gründen begründen 
fondo 		Boden Grund 
fontana 		Brunnen Fontaine Fontäne Springbrunnen 
fonte 		Born Quelle 
forbici 		Schere 
forca 		Galgen 
forchetta 		Gabel 
forestiere 		Ausländer 
formaggio 		Käse 
formato 		Format 
formica 		/f/-Ameise/f/ 
formula 		Formel 
fornaio 		Bäcker 
forse 		eventuell möglicherweise vielleicht wohl 
forte 		kräftig stark 
forza 		Gewalt Kraft 
forzare 		zwingen 
forza 		Anziehungskraft 
fragola 		Erdbeere 
francese 		französisch 
francobollo 		Briefmarke 
frangia 		Frange Franse 
frase 		Phrase Redensart Satz 
frassino 		Esche 
fratello 		Bruder 
fraternit 		Brüderlichkeit 
fra 		bald alsbald baldig 
freccia 		Weisheit Klugheit 
fregata 		Fregatte 
freno 		Bremse 
frequentemente 		häufig oft 
fresco 		frisch neu unberührt 
friggere 		backen braten 
frizione 		Kupplung 
fronte 		Stirn 
frontiera 		Grenze Schranke 
frumento 		Weizen 
frutta 		Frucht 
fucilare 		erschießen füsilieren 
fucile 		Gewehr 
fuga 		Flucht 
fuggire 		ausreißen entfliehen entlaufen fortlaufen sich verlaufen 
fumaiuolo 		Schornstein 
fumare 		rauchen 
fumatori 		Raucherabteil 
fumo 		Rauch 
fungo 		Erdschwamm Pilz 
funzionario 		Beamter 
funzione 		Funktion Tätigkeit Wirksamkeit 
fuoco 		Feuer 
fuori 		äußerlich draußen 
furibondo 		rasend stürmisch toll wütend 
furioso 		rasend stürmisch toll wütend 
furto 		Diebstahl 
gabbiano 		Möwe 
gabinetto 		Abort Abtritt 
galera 		Galeere 
galleria 		Galerie Stollen Wandelgang 
gallina 		Henne 
gallo 		Hahn 
gamba 		Bein 
gambero 		Krebs 
garanzia 		Garantie Gewähr 
garofano 		Nelke 
gas 		Gas 
gatto 		/m/-/gen/Katze/f/;Kater/m/ 
gazza 		Elster 
gelarsi 		erfrieren 
gelo 		Frost 
gelosia 		Eifersucht 
gelso 		Maulbeerbaum 
gemere 		ächzen jammern seufzen stöhnen wehklagen wimmern 
generale 		allgemein 
generalmente 		generell überhaupt 
generazione 		Generation Geschlecht 
genere 		Abart Art Gattung Schlag Sorte 
genero 		Eidam Schwiegersohn 
gengiva 		Zahnfleisch 
genitori 		Eltern 
gennaio 		/m/-Januar/m/ 
gente 		Leute 
gentiluomo 		/m/-Adlige(r)/f(m)/;Gentleman/m/ 
geografia 		Erdbeschreibung Erdkunde Geographie 
gergo 		Gaunersprache Slang 
gestione 		Verwaltung 
gesto 		Gebärde Geste 
gettare 		schleudern werfen 
ghiaccio 		Eis 
ghianda 		Eichel 
giallo 		gelb 
giapponese 		Japaner 
giardiniere 		Gärtner 
giardino 		Anlage Garten 
ginocchio 		Knie 
giocare 		spielen 
gioia 		Freude 
gioielliere 		Juwelier 
giornale 		Journal Zeitung 
giornale 		Abendzeitung 
giornaliero 		täglich 
giornalista 		Journalist 
giorno 		/m/-Tag/m/ 
giostra 		/f/-Karussell/n/ 
giovamento 		/m/-Nutzen Vorteil/m/ 
giovane 		-/adj/jung 
giovare 		dienen frommen nützen 
gioved 		/m/-Donnerstag/m/ 
giraffa 		Giraffe 
giudice 		Richter 
giudizio 		Gericht Gutachten Spruch Urteil 
giugno 		/m/-Juni/m/ 
giuocattolo 		Spielzeug 
giuoco 		Aufführung Spiel 
giuramento 		Eid 
giurare 		beeidigen schwören beschwören 
giustamente 		bündig 
giusto 		bündig 
gi 		unten unterhalb 
gi 		bereits schon 
gli 		das der die 
globo 		Globus Kugel 
goccia 		Tropfen 
gola 		Gurgel Kehle 
gomito 		Ellbogen 
gomma 		Gummi Kautschuck 
gorga 		Gurgel Kehle 
governare 		herrschen beherrschen regieren 
gradevole 		freundlich 
grado 		Grad Staffel Stufe 
granaio 		Baracke Bude Hütte Scheune 
granata 		Besen 
grande 		groß 
grandezza 		Größe 
grandine 		Hagel 
granturco 		Mais 
grasso 		feist fett fettig geil 
grato 		dankbar erkenntlich 
grave 		arg bedeutend bedeutsam beträchtlich erheblich ernst wichtig 
grazie 		Dank 
grazioso 		freundlich 
greco 		griechisch 
gridare 		schreien 
grigio 		grau 
grosso 		dick 
gruppo 		Ar 
guadagnare 		erringen gewinnen 
guadagno 		Errungenschaft 
guancia 		Backe Wange 
guanciale 		Kissen Kopfkissen 
guardaroba 		Garderobe Kleidung Zeug 
guardia 		Polizist Schutzmann 
guarire 		behandeln heilen kurieren 
guarnigione 		Besatzung Garnison 
guerra 		Krieg 
gufo 		Eule 
guidare 		führen leiten lenken 
gustare 		schmecken 
gusto 		/m/-Geschmack/m/ 
i 		das der die 
idea 		Gedanke Idee Vorstellung 
idolo 		Abgott Götze Idol 
idoneo 		begabt fähig imstande tüchtig 
ieri 		gestern 
ignorante 		albern dumm 
il 		das der die 
illuminare 		illuminieren 
illustrazione 		Ansicht Bild 
il 		Allerseelen 
imboccatura 		Mündung 
imitare 		imitieren nachahmen nachbilden 
immagine 		Ansicht Bild 
immediatamente 		alsbald flugs gleich sofort sogleich umgehend 
imparare 		lernen 
impaurire 		zurückschrecken 
impedire 		behelligen hindern behindern inhibieren stören verhindern 
impiego 		/m/-Beschäftigung Stelle/f/;Gebrauch/m/ Verwendung Anwendung/f/ 
impero 		Kaiserreich Kaisertum 
impertinente 		frecht impertinent unverschämt 
impiegare 		anwenden benutzen brauchen gebrauchen verwenden verwerten 
impiegato 		Beamter 
impiego 		Amt Anstellung Dienst 
implorare 		abbetteln 
importante 		arg bedeutend bedeutsam beträchtlich erheblich ernst wichtig 
importanza 		Tragweite 
importo 		Betrag Summe 
imposta 		Abgabe Steuer Steuerabgabe 
impresa 		Unternehmung 
improvvisamente 		jäh 
incanto 		Anmut 
inchiostro 		Tinte 
incidente 		Unfall 
incitare 		anreizen aufhetzen reizen aufreizen 
incontrare 		antreffen begegnen 
incontro 		Begegnung 
indiano 		Indianer 
indiano 		Indianer 
indicare 		andeuten weisen anweisen zeigen 
indietro 		zurück 
indirizzare 		adressieren 
indirizzo 		Adresse 
indivia 		Endivie 
indole 		Natur 
indulgenza 		Ablaß 
inezia 		Bagatelle Kleinigkeit 
infame 		ehrlos 
infatti 		fürwahr wahrhaftig wahrlich wirklich 
infedele 		treulos 
infelice 		unglücklig 
infermiera 		Krankenschwester 
infettare 		anstecken infizieren 
infezione 		Ansteckung Infektion 
informare 		Auskunft geben benachrichten informieren mitteilen 
informarsi 		sich erkundigen 
ingaggiare 		werben anwerben 
ingannare 		äffen betrügen hintergehen täuschen 
ingegnere 		Ingenieur 
ingegno 		Talent 
inglese 		englisch 
ingrato 		undankbar 
iniziatore 		Bahnbrecher Pionier 
inizio 		Anfang Beginn 
innamorarsi 		sich verlieben 
inoltre 		andernteils 
inquieto 		bang 
insalata 		Salat 
insegnare 		Auskunft geben benachrichten informieren mitteilen 
inseguimento 		Verfolgung 
inserzione 		Annonce Anzeige Inserat 
insetto 		/m/-Insekt/n/ 
insieme 		aneinander beisammen gesamt insgesamt zugleich zusammen 
insistere 		andringen beharren auf drängen trotzen 
insolente 		frecht impertinent unverschämt 
instruire 		lehren belehren instruieren unterrichten unterweisen 
insudiciare 		beschmutzen einschmutzen sudeln 
insultare 		beleidigen schelten schimpfen beschimpfen 
intendere 		beabsichtigen die Absicht haben vorhaben 
intenzione 		Absicht Plan 
interessare 		interessieren 
interesse 		Interesse Zins 
interno 		innerlich intern inwendig 
intero 		ganz total 
intestino 		Darm 
intorno 		um um ... herum 
intravedere 		erblicken gewahr werden 
invano 		umsonst vergebens vergeblich 
inventare 		entdecken erfinden 
invernale 		/adj/Winter- winterlich 
inverno 		/m/-Winter/m/ 
investire 		einkleiden investieren 
invidiare 		beneiden 
invitare 		einladen 
in 		heim daheim zu Hause 
in 		hinten 
in 		andernfalls anders sonst 
in 		nirgends 
in 		auf keiner Weise gar nicht in keiner Weise keineswegs 
in 		teils 
in 		erst erstens zuerst 
in 		irgendwo 
in 		danach 
in 		beizeiten zeitig zur rechten Zeit 
ippopotamo 		Flußpferd 
irato 		arg böse 
irlandese 		Ire 
irritare 		abstumpfen angreifen 
isola 		Eiland Insel 
isolato 		vereinsamt 
italiano 		Italiener 
la 		das der die 
labbro 		Lippe 
labirinto 		Labyrinth 
laborioso 		arbeitsam geschäftig 
ladro 		Dieb 
laggi 		da dort 
lagnarsi 		klagen sich beklagen verklagen 
lago 		See 
lagrima 		Träne 
lampadina 		Birne 
lampone 		Himbeere 
lapis 		Bleistift Crayon 
lardo 		Speck 
larghezza 		Breite 
largo 		breit weit 
lasciare 		hinterlassen 
lato 		Flanke Seite 
latta 		Blech 
latte 		Milch 
lattuga 		Kopfsalat Lattich Salat 
lavanderia 		Beuchhaus Waschanstalt 
lavare 		spülen waschen 
lavorare 		arbeiten 
lavoro 		Arbeit 
le 		das der die 
legame 		Band 
legare 		binden verbinden 
leggere 		lesen 
legno 		Holz 
legume 		Gemüse 
lei 		die ihr ihrer sie 
lenticchia 		Linse 
lenza 		Angelleine 
lenzuolo 		/m/-Bettuch/n/ /nR/Betttuch/n/ Bettlaken Laken 
leone 		/m/-Löwe/m/ 
lepre 		Hase 
lesto 		anstellig behende fix geschickt geübt gewandt 
lettera 		Brief 
letto 		Bett Bettstelle 
lezione 		Lehraufgabe Lektion Unterrichtsstunde 
li 		da dort 
liberare 		befreien entledigen erledigen freilassen frei machen 
libert 		/f/-Freiheit/f/ 
librario 		Buchhändler 
libreria 		Buchhandlung 
libro 		Buch 
licenzioso 		unbändig zügellos 
lima 		Feile 
limitare 		begrenzen beschränken einschränken 
limone 		Zitrone 
linea 		Linie Strich Zeile 
lingua 		Zunge 
lisca 		Gräte 
liscio 		geläufig glatt 
lista 		Liste Verzeichnis 
livello 		Niveau 
lo 		das der die 
locomotiva 		Lokomotive 
lodare 		loben preisen anpreisen 
lontano 		ab dahin fort heraus weg hinweg 
luccio 		Hecht 
luce 		Licht 
luglio 		/m/-Juli/m/ 
lui 		er ihm ihn seiner 
lumaca 		Schnecke 
luna 		Mond 
luned 		/m/-Montag/m/ 
lungo 		lang 
luogo 		Anstalt Gelaß Ort Platz Stelle 
lupo 		/m/-Wolf/m/ 
lusingare 		schmeicheln 
lusso 		Aufwand Luxus 
l 		dahin dorthin hierhin nach dort 
l 		dahin dorthin hierhin nach dort 
macchina 		Maschine 
macchina 		Schreibmaschine 
macellaio 		Fleischer 
macinare 		mahlen 
madre 		Mutter 
madrevite 		Mutter 
maestra 		Lehrerin 
maestro 		Lehrer 
maggio 		/m/-Mai/m/ 
magro 		mager 
mai 		nie niemals nimmer 
maiale 		Schweinefleisch 
malato 		krank 
mal 		Seekrankheit 
mal 		Bauchweh 
mammifero 		/m/-Säugetier/n/ 
mancanza 		Fehlen Fehler Manko 
mancia 		Trinkgeld 
mandare 		schicken senden einsenden 
mandorla 		Mandel 
mangiabile 		eßbar genießbar 
maniera 		Art Manier Weise 
mano 		Hand 
manzo 		Rindfleisch 
marcia 		Gang 
mare 		Meer See 
marinaio 		Seemann 
maritarsi 		sich verehelichen sich verheiraten 
marito 		Ehemann Gatte Gemahl Gespons 
marmelata 		Konfitüre Marmelade 
marmo 		/m/-Marmor/m/ 
marrone 		braun 
marted 		/m/-Dienstag/m/ 
martello 		Hammer 
marzo 		/m/-MÃ¤rz/m/ 
mascella 		Kiefer Kinnlade 
massa 		Masse 
masticare 		kauen 
matematica 		/f/-Mathematik/m/ 
materasso 		/m/-Matratze/f/ 
materia 		Materie 
materiale 		Material Zutat 
matita 		/f/-/gen/Stift;Bleistift/m/ Crayon 
matrimonio 		Ehe 
mattina 		Frühe Morgen 
matto 		irre toll verrückt wahnsinnig 
mattone 		Backstein Ziegel Ziegelstein 
maturo 		reif 
meccanico 		Mechaniker 
mediante 		durch kraft mit mittelst vermittels 
medico 		Arzt Doktor 
medio 		mittlere mittlerer mittleres Mittel‐ 
megera 		Megäre Weib 
mela 		Apfel 
melo 		Apfelbaum 
melone 		Melone 
membro 		Anhänger Glied 
memoria 		Andenken 
mendicante 		Bettler 
mensile 		-/adj/monatlich Monat- 
menta 		Minze 
mentire 		flunkern lügen belügen 
mento 		Kinn 
menzionare 		nennen 
mercanteggiare 		dingen feilschen markten 
mercato 		Marktplatz 
merce 		Artikel 
mercoled 		/m/-Mittwoch/m/ 
meritare 		verdienen 
merlo 		Amsel 
merluzzo 		Dorsch Kabeljau 
mese 		/m/-Monat/m/ 
mestiere 		Beruf Gewerbe Handwerk 
metallo 		Metall 
metodo 		Methode 
mettere 		legen setzen stecken stellen 
met 		Hälfte 
mezzo 		halb 
miele 		Honig 
migliaio 		Tausend 
migliorare 		bessern ausbessern verbessern veredeln 
migliore 		best 
milione 		Million 
mille 		tausend 
minaccia 		Bedrohung Drohung 
minacciare 		bevorstehen dräuhen drohen bedrohen 
minerale 		Mineral 
minestra 		Suppe 
ministero 		Ministerium 
mio 		mein 
miope 		kurzsichtig 
miserabile 		elend erbärmlich jämmerlich 
miseria 		Elend Not 
misero 		elend erbärmlich jämmerlich 
misterioso 		geheimnissvoll mysteriös 
mistura 		Gemisch 
misura 		Maß 
misurare 		messen abmessen aufmessen 
misurato 		gemessen 
mite 		mild 
mobile 		beweglich 
mobili 		Hausgerät Mobilär 
modesto 		anspruchslos bescheiden 
modista 		Modistin 
modo 		Art Manier Weise 
moglie 		Frau Gemahlin 
molla 		Feder Triebfeder 
molle 		weich 
moltiplicare 		multiplizieren 
molto 		viel zahlreich 
mondano 		weltlich 
mondo 		Welt 
moneta 		Geldstück Münze 
monologo 		Monolog 
monotono 		eintönig monoton 
montagna 		Berg 
montagne 		Gebirge 
monte 		Berg 
monumento 		Denkmal Monument 
mordere 		beißen 
morire 		sterben 
mortale 		tödlich 
morte 		Tod 
morto 		gestorben tot verstorben 
mosca 		/f/-Fliege/f/ 
mostarda 		Mostrich Senf 
mostrare 		andeuten weisen anweisen zeigen 
mostro 		Monstrum Ungeheuer Ungetüm Unhold 
motocicletto 		Kraftfahrrad Motorrad 
motore 		Motor 
movimento 		Bewegung 
muggire 		brausen sausen zischen 
mulo 		Maulesel Maultier 
multa 		Geldstrafe 
municipio 		Rathaus 
muovere 		bewegen erregen 
muoversi 		sich bewegen 
muro 		Mauer Wand 
muscolo 		Muskel 
museo 		Museum 
musicista 		Musiker 
mutande 		Unterhose 
muto 		sprachlos stumm 
nano 		Zwerg 
nascere 		entstehen 
nascita 		Abkunft Abstammung Herkunft Ursprung 
nascondere 		bergen hehlen verbergen verhehlen verheimlichen verstecken 
naso 		Nase 
nastro 		Band 
natura 		Natur 
naturalmente 		natürlich 
navata 		Schiff 
nazionale 		national 
nebbia 		Nebel 
necessario 		erforderlich nötig notwendig 
negare 		leugnen verneinen 
negligente 		achtlos fahrlässig 
negozio 		Butike Geschäft Kramladen Laden 
nero 		schwarz 
nervo 		Nerv 
neutrale 		neutral sächlig 
neutro 		neutral sächlig 
neve 		Schnee 
nevicare 		schneien 
niente 		durchaus nicht ganz und gar nicht ganz nicht 
nipote 		Enkelin 
no 		nein 
nobilt 		Adel 
nocciola 		Haselnuß 
nocciuola 		Haselnuß 
noce 		Nußbaum 
nocivo 		schädlich 
nodo 		Knoten 
noi 		uns unser wir 
nome 		Name 
non 		kein nicht 
noncurante 		achtlos fahrlässig 
nonna 		Großmutter 
nonni 		Großeltern 
nonno 		Großvater 
non 		allein bloß erst lediglich nur 
non 		nie niemals nimmer 
non 		nicht mehr 
nord 		Norden 
norvegese 		Norweger 
notaio 		Notar 
noto 		bekannt 
notte 		Nacht 
novanta 		neunzig 
nove 		neun 
novella 		Braut 
novembre 		/m/-November/m/ 
nozione 		Gedanke Idee Vorstellung 
nube 		Wolke 
nudo 		bloß nackt 
numero 		Anzahl Zahl 
nuocere 		beeinträchtigen 
nuotare 		schwimmen 
nuovo 		neu 
nuvola 		Wolke 
nuvolo 		Wolke 
oca 		Gans 
occhiali 		Augengläser Brille 
occorrente 		erforderlich nötig notwendig 
occupare 		bekleiden besetzen einnehmen in Anspruch nehmen 
occupato 		besetzt 
occupazione 		Beschäftigung 
odiare 		hassen 
odio 		Haß 
offendere 		beleidigen schelten schimpfen beschimpfen 
offerta 		Anerbieten Offerte 
ogetto 		Ding Gegenstand Objekt 
oggi 		heute 
ogni 		täglich alltäglich 
ogni 		allerlei 
ogni 		dann und wann von Zeit zu Zeit zeitweilig 
olandese 		Holländer 
olio 		Öl 
oliva 		Olive 
olivo 		Olivenbaum 
olmo 		Rüster Ulme 
ombra 		Schatten 
omero 		Oberarm 
onda 		Welle Woge 
onesto 		anständig bieder ehrlich honett rechtschaffen 
onnisciente 		allwissend 
onore 		Ehre 
onorevole 		achtbar 
ontano 		Erle 
opera 		Werk 
operaio 		Arbeiter 
opprimere 		erpressen unterdrücken 
ordinare 		bestellen 
ordine 		Auftrag Bestellung 
orecchio 		Ohr 
orgoglioso 		hochfahrend hochmütig stolz 
origine 		Abkunft Abstammung Herkunft Ursprung 
origliare 		belauschen 
orinare 		harnen 
orizzonte 		gesichtskreis Horizont 
orlo 		Grat Kante Saum Rand 
orlogiaio 		Uhrmacher 
oro 		Gold 
orologio 		Uhr 
orrore 		Abscheu Greuel 
orso 		Bär 
orso 		Eisbär 
ortica 		Brennessel 
orzo 		Gerste 
oscurit 		Dunkelheit 
oscuro 		dunkel finster 
ospedale 		Hospital Hospiz Krankenhaus 
ospitale 		gastlich 
ospite 		Gast 
osservare 		beaufsichtigen beobachten betrachten vervolgen 
osservazione 		Bemerkung Beobachtung Vermerk 
osso 		Gebein Knochen 
ostinato 		eigensinnig halsstarrig hartnäckig starrköpfig trotzig 
ostrica 		Auster 
ottanta 		achtzig 
ottenere 		holen 
ottico 		Optiker 
otto 		acht 
ottobre 		/m/-Oktober/m/ 
ottone 		Messing 
ovest 		Abendland Okzident Westen 
pacco 		Bündel Päckchen Paket 
pace 		Friede 
pacificare 		besänftigen dämpfen züchtigen 
padre 		Vater 
padre 		Eltern 
padrone 		Wirt 
paese 		Land 
paga 		Gage Gehalt Salär 
pagamento 		Bezahlung Zahlung 
pagare 		zahlen abzahlen auszahlen bezahlen einzahlen entrichten 
pagina 		Folio Seite 
palato 		Gaumen 
palazzo 		Palast Schloß 
palese 		anschaulig augenscheinlich ersichtlich evident offenbar 
palla 		Kugel 
pallido 		blaß bleich fahl 
pallone 		Ballon 
pallottoliere 		Abakus Kugelmaschine Rechenmaschine 
palma 		Handfläche 
palpebra 		Augenlid 
pane 		Brot 
panetteria 		Bäckerei Backstube 
panino 		Brötchen Semmel 
panka 		Bank 
pantaloni 		Beinkleid Hose 
pappagallo 		Papagei 
parafango 		Kotflügel 
parallelo 		gleichlaufend parallel 
parapetto 		Balustrade Geländer Schranke 
parentado 		Verwandtschaft 
parente 		Verwandter 
parentela 		Verwandtschaft 
parento 		verwandt anverwandt 
parere 		scheinen 
parete 		Wand 
parlare 		reden sprechen 
parola 		Vokabel Wort 
parrucchiere 		Friseur Frisör 
parte 		Anteil Teil 
partenza 		Abgang Abreise Abzug 
participio 		Mittelwort Particip Participium 
particulare 		privat 
partire 		abreisen fortgehen 
partito 		Anhang 
parzialmente 		teils 
passaggio 		Bahnübergang 
passagiere 		Fahrgast Passagier 
passaporto 		Paß Reisepaß 
passare 		angeben herreichen verbringen zubringen 
passato 		Vergangenheit 
passeggiata 		Foyer 
passero 		/m/-Sperling;Spatz/m/ 
passo 		Schritt Tritt 
pasta 		Pasta Paste Teig 
patata 		Erdapfel Kartoffel 
patria 		Heimat Vaterland 
patto 		Einverständnis Übereinkunft 
pattuire 		sich verständigen übereinkommen verabreden vereinbaren 
paura 		Angst 
pauroso 		bang feige 
pavimento 		Boden Diele Dielung Fußboden 
pazienza 		Geduld 
pazzo 		Irre 
pecora 		Hammel Schaf 
pelegrinaggio 		Wallfahrt 
pelle 		/f/-Fell/n/ Balg Peltz Tierhaut 
pellicola 		Film 
penna 		/f/-Feder/f/ 
pendere 		hängen 
penetrare 		durchdringen eindringen 
penisola 		Halbinsel 
penna 		Feder 
penna 		Füller Füllfeder 
pensare 		denken 
pensiero 		Gedanke 
pensione 		Fremdenheim Pension 
pentimento 		Buße 
pepe 		Pfeffer 
pera 		Birne 
perci 		also daher darum deshalb 
percorrere 		durchgehen durchqueren hindurchgehen 
perdere 		verlieren 
perdere 		abgewöhnen 
perdersi 		sich verirren 
perdita 		Verlust 
perduto 		abhanden 
perfetto 		perfekt trefflich vollendet vollkommen 
perfino 		gar ja selbst sogar 
pericolo 		Gefahr 
pericoloso 		besorglich gefährlich 
perito 		Buchrevisor 
permanente 		fest 
permettere 		erlauben gestatten 
pernice 		Rebhuhn 
perno 		Achse 
pero 		Birnbaum 
perseguire 		fahnden nachzusetzen verfolgen 
perseguitare 		fahnden nachzusetzen verfolgen 
persiana 		Jalousie Rolladen 
persona 		Person 
personale 		persönlich 
per 		gewissermaßen 
per 		zum Beispiel 
per 		wenigstens 
per 		durch kraft mit mittelst vermittels 
per 		lange 
per 		also daher darum deshalb 
per 		Schwieger‐ 
pesante 		schwer 
pesare 		wägen abwägen wiegen 
pesce 		/m/-Fisch/m/ 
pescecane 		Hai Haifisch 
pesce 		Barsch 
peso 		Gewicht Wucht 
pestare 		frankieren 
petizione 		Bittschrift 
petrolio 		Petroleum 
pettegolezzo 		Geplauder 
pettinare 		kämmen 
petto 		Brust Busen 
pezzo 		Fleck Stück 
piacere 		behagen belieben gefallen konvenieren 
piacevole 		behaglich herrlich genehm angenehm 
pialla 		Hobel 
piangere 		weinen 
piano 		eben glatt flach 
pianola 		Klaviatur Tastatur 
pianta 		Fußsohle Sohle 
piantare 		legen stecken pflanzen anpflanzen 
pianterreno 		Erdgeschoß 
piattaforma 		Bahnsteig Kai 
piattino 		Untertasse 
piatto 		Teller 
piazza 		Platz 
picchiare 		klopfen schlagen 
piccione 		Taube 
piccola 		Dirne Mädchen 
piccolo 		gering klein 
pidocchio 		Laus 
piegare 		falten zusammenlegen 
pieno 		voll 
pierra 		Stein 
pigro 		faul 
pinna 		Flosse 
pino 		Föhre Kiefer 
pioggia 		Regen 
piombo 		Blei 
pioniere 		Bahnbrecher Pionier 
pioppo 		Pappel 
piovere 		regnen 
pisciare 		harnen 
pisello 		Erbse 
pista 		Bahn Chaussee Strecke Weg 
pittore 		Maler 
pittura 		Ansicht Bild 
piuttosto 		lieber 
placare 		besänftigen dämpfen züchtigen 
plenilunio 		Vollmond 
poco 		allmählich nach und nach sukzessive 
poema 		Gedicht Poem 
poema 		Epik Epopöe Heldengedicht 
poesia 		Dichtkunst Dichtung Poesie 
poeta 		Dichter Poet 
poggiare 		stemmen unterhalten unterstützen 
poi 		danach 
polacco 		Pole 
politica 		Politik 
politico 		politisch 
polizia 		Polizei 
poliziotto 		Polizist Schutzmann 
pollice 		Daumen 
pollo 		Huhn 
polmone 		Lunge 
polpaccio 		Wade 
polso 		Handgelenk 
poltrona 		Fauteuil Lehnstuhl 
polvere 		Staub 
pomeriggio 		Nachmittag 
pomodoro 		Tomate 
pompa 		Pumpe 
pompare 		pumpen 
ponere 		legen setzen stecken stellen 
ponte 		Deck Schiffsdeck Verdeck 
popolo 		Volk 
poppa 		Heck 
populazione 		Bevölkerung 
porcellino 		/m/-Meerschweinchen/n/ 
porco 		Schwein 
porta 		Tür 
portacenere 		Aschenbecher 
portalettere 		Briefträger 
portare 		bringen anbringen eintragen heranbringen überbringen 
portiera 		Wagentür 
porto 		Hafen 
portoghese 		Portugiese 
porzione 		Anteil Teil 
posa 		Gezier 
posare 		affektieren künsteln sich zieren 
posdomani 		übermorgen 
possedere 		besitzen 
possesso 		Besitz Besitztum Besitzung Eigentum Gut 
possibile 		angängig etwaige 
posta 		Post 
postino 		Briefträger 
potabile 		genießbar 
potere 		Gewalt Macht Potenz 
povero 		arm 
povert 		Armut 
praticare 		praktizieren 
preciso 		akkurat genau 
predisporre 		arrangieren einrichten ordnen anorden veranstalten 
pregare 		beten 
preghiera 		Gebet 
pregiudizio 		Vorurteil 
premere 		beklemmen drücken bedrücken pressen zwängen 
premio 		Prämie Preis 
prendere 		erbeuten ergreifen ertappen erwischen fangen fassen 
prendere 		versorgen 
prendere 		mieten 
prenome 		Vorname 
preparare 		bereiten vorbereiten 
presente 		Angebinde Gabe Geschenk Spende Vermächtnis 
pressione 		Drang Druck Drücken Pressen 
presto 		flugs geschwind schnell 
prete 		Geistliche Pastor Pfarrer Priester 
prezzemolo 		Petersilie 
prezzo 		Preis 
primavera 		/f/-Frühling/m/ 
primaverile 		Frühlings- frühlingshaft 
prigione 		Gefängnis Verlies 
prigioniero 		Arrestant 
prima 		erst erstens zuerst 
primavera 		Frühjahr Frühling Lenz 
prima 		Frühstück 
primo 		erste erster erstes 
principale 		Wirt 
principalmente 		besonders eigens insbesondere vornehmlich vorzüglich zumal 
principio 		Anfang Beginn 
privado 		privat 
probabile 		wahrscheinlich 
probabilmente 		wahrscheinlich wohl 
problema 		Problem 
processo 		Prozeß 
proclamare 		ausrufen proklamieren 
prodotto 		Artikel 
produrre 		erzeugen hervorbringen produzieren 
professione 		Beruf Gewerbe Profession 
profitto 		Ertrag Gewinn Interesse Nutzen Überschuß Verdienst Vorteil 
profondit 		Tiefe 
profondo 		tief 
progettare 		entwerfen planen projektieren 
progetto 		Abriß Entwurf Plan Riß Grundriß 
progresso 		Fortschritt 
promessa 		Gelöbnis Versprechen Zusage 
promettere 		geloben verheißen versprechen zusagen 
promozione 		Promotion 
promuovere 		promovieren 
pronipote 		Großenkel Urenkel 
pronto 		bereit erbötig fertig 
pronunciare 		aussprechen fällen 
proporzionale 		proportional verhältnismäßig 
proposito 		Ziel Zweck 
proprietario 		Eigentümer Inhaber 
proprio 		eigen 
prosciutto 		Schinken 
prosperare 		gedeihen gelingen geraten glücken prosperieren 
prossimo 		bevorstehend kommend künftig nächst nahe 
proteggere 		begünstigen beschirmen protektieren schützen beschützen 
protesta 		Einspruch 
protestare 		anfechten beanstanden Einspruch erheben protestieren 
protezione 		Begünstigung Protektion Schirm Schutz 
prova 		Ausweis Beweis Beleg 
provare 		erproben probieren prüfen versuchen 
prua 		Bug 
pubblicare 		ankündigen anzeigen avisieren melden anmelden verkünden 
pubblicazione 		Proklamation 
pubblico 		öffentlich 
pugnale 		Dolch 
pugno 		Faust 
pulce 		/f/-Floh/m/ 
pulizia 		/f/-Sauberkeit/f/;Saubermachen/n/ Reinheit Reinlichkeit 
pulire 		reinigen säubern 
pulsante 		Knopf 
pungere 		stacheln stechen stecken sticheln 
pungiglione 		Stachel 
punire 		ahnden strafen bestrafen züchtigen 
punizione 		Bestrafung Strafe 
punta 		Kulm Spitze Stift Zacke Zinke Zipfel 
punteruolo 		Ahle Pfrieme 
punto 		Punkt 
puro 		rein 
qualche 		manchmal 
quaranta 		vierzig 
quarto 		Viertel Viertelstunde 
quasi 		beinahe fast nahezu schier ungefähr 
quattordici 		vierzehn 
quattro 		vier 
quercia 		Eiche 
questura 		Polizeiamt Polizeiwache 
qui 		hierher hierhin nach hier 
quindici 		fünfzehn 
quotidianamente 		täglich alltäglich 
quotidiano 		täglich 
qu 		hierher hierhin nach hier 
raccogliere 		sammeln einsammeln 
raccomandabile 		empfehlungswert 
raccomandare 		raten beraten ratgeben 
raccomandazione 		Empfehlung 
raccontare 		erzählen 
radio 		Radio 
raffredarsi 		sich erkälten 
raffreddore 		Erkältung 
ragazza 		Dirne Mädchen 
ragazzo 		Junge Knabe 
ragione 		Rationalität Vernunftgemäßheit 
ragnatela 		/f/-Spinnennetz/n/ 
ragno 		/m/-Spinne/f/ 
rame 		Kupfer 
ramo 		Ast Zweig 
rana 		/f/-Frosch/m/ 
ranocchio 		Frosch 
rapa 		Rübe 
rappresentare 		repräsentieren vertreten vorstellen 
raramente 		selten 
raschiare 		kratzen ritzen 
rassomiglare 		ähneln gleichen 
ratto 		/m/-Ratte/f/ 
ravanello 		Radieschen 
razza 		Rasse 
reale 		real wirklich 
recitare 		rezitieren vortragen 
regalo 		Angebinde Gabe Geschenk Spende Vermächtnis 
regime 		Diät 
regno 		Königreich 
regola 		Regel 
relazione 		Beziehung Hinsicht Verbindung Verhältnis 
remo 		Lenkrad Ruder Steuer 
rendere 		erschweren 
rene 		Niere 
replicare 		antworten beantworten entgegnen erwidern 
repubblica 		Freistaat Republik 
residenza 		Wohnort Wohnsitz 
respirare 		atmen 
respirazione 		Atmen Atmung 
responsabile 		verantwortlich 
restare 		bleiben übrigbleiben 
restituire 		vergelten wiedergeben zurückgeben 
resti 		zurückbleiben 
restringere 		begrenzen beschränken einschränken 
rete 		Garn Netz 
retroguardia 		Nachhut 
ribes 		Stachelbeere 
ribes 		Aalbeere 
ribrezzo 		Abscheu Greuel 
ricchezza 		Reichtum 
riccio 		Igel 
ricco 		ausgiebig reich vermögend 
ricevere 		bekommen empfangen erhalten 
ricevuta 		Quittung 
ricompensa 		Belohnung Lohn 
ricompensare 		lohnen belohnen vergelten 
riconoscente 		dankbar erkenntlich 
ricovero 		Asyl Zufluchtsstätte 
ridere 		lachen 
ridicolo 		lächerlich 
rifiutare 		ausmerzen 
rifiutarsi 		ablehnen abschlagen ausschlagen versagen weigern verweigern 
rifiuto 		Verweigerung Weigerung 
rigido 		starr steif spröde 
riguardare 		angehen anlangen betreffen 
riguardo 		Achtung Verehrung 
rilegare 		binden einbinden 
rilevare 		ablösen ersetzen 
rimanere 		bleiben übrigbleiben 
rimorchiatore 		Schlepper 
rimpianto 		Buße 
rincrescere 		bedauern 
ringraziare 		danken sich bedanken verdanken 
rinoceronte 		Nashorn 
rinomato 		berühmt 
rinviare 		zurücksenden 
riparare 		reparieren 
ripetere 		wiederholen 
ripido 		abschüssig steil 
riposarsi 		ruhen sich ausruhen 
riposo 		Ruhe 
riprendere 		schelten vorwerfen Vorwürfe machen 
ripugnanza 		Abneigung Antipathie Wiederwillen 
risa 		Gelächter Lache 
riscaldamento 		/m/-Heizung/f/ 
riscaldare 		heizen (er)wärmen 
rischio 		Risiko Wagnis 
riservare 		reservieren vorbehalten zurückbehalten 
riso 		Lachen 
rispettabile 		achtbar 
rispettare 		achten hochschätzen 
rispetto 		Achtung Verehrung 
risplendere 		blinken glänzen scheinen schimmern strahlen 
rispondere 		antworten beantworten entgegnen erwidern 
risposta 		Antwort 
ristorante 		Restaurant Restauration 
risultato 		Erfolg Ergebnis Resultat 
ritenere 		zurückhalten 
ritirare 		abräumen fortnehmen entziehen fortnehmen wegnehmen 
ritirata 		Abort Abtritt 
ritornare 		zurückkehren 
riuscire 		Erfolg haben gelingen 
rivista 		Zeitschrift 
roccia 		Fels Felsen Steinmasse 
romanzo 		Roman 
rompere 		abreißen losreißen pflücken abpflügen 
rompersi 		brechen 
rondine 		Schwalbe 
rospo 		/m/-Kröte/f/ 
rosso 		rot 
rotondo 		rund 
rovesciare 		kappen umstoßen umstürzen umwerfen 
rovinare 		verheeren 
rozzo 		barsch ungezogen unverfroren 
rubare 		entwenden stehlen 
rude 		brummig unwirsch 
rugiada 		Tau 
rumore 		Aufsehen Braus 
ruota 		Rad 
ruscello 		Bach 
russare 		schnarchen 
russo 		Russe 
sabato 		/m/-Samstag Sonnabend/m/ 
sabbia 		Sand 
sacerdate 		Geistliche Pastor Pfarrer Priester 
saggio 		gescheit klug weise 
salario 		Gage Gehalt Salär 
sala 		Badestube 
sala 		Speisesaal Speisezimmer 
sala 		Warteraum Wartesaal 
salcio 		Weide 
saldare 		saldieren 
sale 		Salz 
salice 		Weide 
salire 		aufgehen sich erheben steigen 
salmone 		Lachs Salm 
salotto 		Aula Salon 
salsa 		Brühe Sauce Soße Tunke 
salsiccia 		Wurst 
saltare 		springen 
salto 		Sprung 
salutare 		grüßen begrüßen bewillkommnen 
salute 		Gesundheit 
saluto 		Gruß 
salvare 		retten erlösen erretten 
salvia 		Salbei 
salvo 		ausgenommen 
sangue 		Blut 
sanguinare 		bluten 
sapere 		wissen 
sarto 		Schneider 
sbadato 		achtlos fahrlässig 
sbadigliare 		gähnen 
sbadiglio 		Gähnen 
sbagliarsi 		sich irren 
sbaglio 		Fehler Irrtum Versehen 
sbalordire 		in Verwunderung setzen verwundern 
sbarrare 		hindern sperren versperren 
sbocco 		Markt 
scala 		Stiege Treppe 
scalpello 		Meißel Stemmeisen 
scandalo 		Ärgernis Skandal 
scarpa 		Schuh 
scatola 		Büchse Schachtel 
scegliere 		auslesen wählen auswählen erwählen 
scelta 		Auslese Wahl 
scheletro 		Gebein Gerippe Knochengerüst Skelett 
scherzare 		scherzen 
scherzo 		Jux Scherz Spaß 
schiuma 		Gischt Schaum 
scienza 		Wissenschaft 
scimmia 		/f/-Affe/m/ 
scimpanz 		/m/-Schimpanse/m/ 
scintilla 		Funke 
sciocchezza 		Torheit 
sciocco 		albern dumm 
sciopero 		Strahl 
scoiattolo 		/m/-Eichhorn Eichhörnchen/n/ 
scolaro 		Schüler 
scommettere 		wetten 
scompartimento 		Abteil Coupé Kupee 
sconsigliare 		entraten 
scopa 		Besen 
scopo 		Ziel Zweck 
scoprire 		abdecken entdecken enthüllen 
scorgere 		erblicken gewahr werden 
scorrere 		fließen rinnen strömen 
scorso 		letzte letzter letztes 
scortese 		barsch ungezogen unverfroren 
scorza 		Bast 
scozzese 		Schotte 
screpolatura 		Spalte 
scrivere 		schreiben 
scrivere 		tippen 
scultura 		Bildhauerwerk Bildwerk 
scuola 		Schule 
scure 		Axt Beil Hacke 
scuro 		dunkel düster trübe 
se 		falls insofern wenn wofern 
sebbene 		obgleich obschon wenn auch zwar 
seccare 		dörren trocknen austrocknen 
secchia 		Eimer 
secchio 		Eimer 
secco 		trocken 
secondo 		Sekunde 
sedano 		Sellerie 
sedere 		/m/-Hintern/m/ Gesäß/n/ After Arsch 
sedersi 		sich setzen 
sedia 		Stuhl 
sedici 		sechzehn 
sega 		Säge 
segale 		Roggen 
segno 		Abzeichen Anzeichen Kennzeichen Merkzeichen Wink Zeichen 
segreto 		geheim heimlich verborgen verstohlen 
seguente 		folgend nächst umgehend 
seguire 		folgen 
seguito 		Anhang 
sei 		sechs 
selvaggina 		/f/-Wild/n/ 
selvaggio 		wild 
seminare 		säen 
semplice 		einfach einfältig 
sempre 		allemal allzeit fortwährend immer jederzeit stets 
sensato 		gescheit klug vernünftig verständig 
sentiero 		Fußweg Pfad Steg Steig 
sentire 		duften riechen 
senza 		grundlos 
separare 		absondern abteilen abtrennen scheiden 
separato 		abgesondert besonder einzeln seperat 
seppellire 		beerdigen 
sera 		Abend 
serio 		ernst ernsthaft gesetzt 
serpente 		/m/-Schlange/f/ 
serrare 		beklemmen drücken bedrücken pressen zwängen 
serrare 		schließen verschließen zuschließen 
serratura 		Schloß Verschluß 
servire 		dienen bedienen 
servizio 		Bedienung Dienst 
sessanta 		sechzig 
sesso 		Geschlecht Sex 
sete 		Durst 
settanta 		siebzig 
sette 		sieben 
settembre 		/m/-September/m/ 
settimana 		Woche 
severo 		streng 
sfera 		Sphäre 
sferico 		sphärisch 
sfruttare 		ausbeuten ausnutzen exploitieren 
sgelare 		tauen auftauen 
sgombro 		Makrele 
sgradevole 		wiederwärtig 
sgretolarsi 		bröckeln 
sguardo 		Überblick 
sicurezza 		Sicherheit 
sidro 		Apfelwein Obstwein Zider 
significare 		bedeuten bezeichnen 
significato 		Bedeuting Bezeichnung Meinung 
silenzioso 		schweigend verschwiegen 
simile 		ähnlich 
sincero 		aufrichtig 
sindaco 		Bürgermeister 
sistema 		System 
sistemare 		arrangieren einrichten ordnen anorden veranstalten 
si 		zweifelsohne 
smarrirsi 		sich verirren 
smercio 		Absatz Debit Vertrieb 
smussato 		stumpf 
snello 		behende gewandt 
sociale 		sozial 
soffiare 		blasen wehen 
soffitto 		Decke Zimmerdecke 
soffocare 		erdrosseln ersticken erwürgen 
sofisma 		Sophisma 
soglia 		Schwelle 
sogliola 		Seezunge 
sognare 		träumen 
sogno 		Traum 
soldi 		Geld 
sole 		Sonne 
solere 		sich gewöhnen 
solo 		allein alleinig bloß einzig 
soltanto 		allein bloß erst lediglich nur 
somaro 		/m/-Esel/m/ 
somma 		Betrag Summe 
sommario 		Übersicht 
sonare 		gellen klingen läuten tönen 
sonno 		Schlaf 
sopportare 		dulden 
sopra 		oberhalb über 
sopracciglio 		Augenbraue 
soprattutto 		besonders zunächst zuvörderst 
sorcio 		Maus 
sordo 		taub 
sordomuto 		taubstumm 
sorella 		Schwester 
sorgente 		Born Quelle 
sorprendere 		befremden überfallen überraschen 
sorpresa 		Überraschung 
sorpreso 		verwundert 
sorridere 		lächeln 
sospendere 		anhängen aufhängen erhängen henken 
sospettare 		argwöhnen verdächtigen 
sospetto 		Argwohn Verdacht 
sostegno 		Stütze 
sostenere 		anlegen lehnen anlehnen stemmen stützen unterstützen 
sotto 		unter unterhalb 
sovente 		häufig oft 
spada 		Degen 
spagnolo 		Spanier 
spagnuolo 		Spanier 
spalla 		/f/-Schulter/f/ Achsel/f/ 
spartire 		mitmachen teilnehmen 
spaventare 		zurückschrecken 
spazio 		Gelaß Raum 
spazzola 		Bürste 
specchio 		Spiegel 
speciale 		spezial speziell 
specie 		Abart Art Gattung Schlag Sorte 
spegnere 		auslöschen dämpfen 
spendere 		auslegen verausgaben 
spengere 		auslöschen dämpfen 
speranza 		Hoffnung 
sperare 		hoffen 
spesso 		dick 
spezzare 		brechen abbrechen aufbrechen 
spiacevole 		wiederwärtig 
spiaggia 		Strand 
spiare 		belauschen spionieren 
spicciole 		Kleingeld 
spiegare 		darlegen einleuchten erklären erläutern 
spiegazione 		Aufklärung Aufschluß Erläuterung 
spiga 		Ähre 
spina 		Dorn Grat Stachel 
spinaci 		Spinat 
spina 		Rückgrat 
spingere 		dringen rücken stoßen treiben 
spinta 		Stoß Trieb 
spirito 		Geist Genius 
spiritoso 		geistreich sinnreich witzig 
spirituale 		Geistes‐ geistig intellektuell 
sporcare 		beschmutzen einschmutzen sudeln 
sport 		Sport 
sportello 		Schalter Schalterfenster Schiebefenster 
sposa 		Braut 
sposato 		verheirated 
sposo 		Ehemann Gatte Gemahl Gespons 
spossare 		strapazieren 
sprezzo 		Verachtung 
spronare 		anreizen aufhetzen reizen aufreizen 
spuntato 		stumpf 
sputare 		speien spucken 
squama 		Schuppe 
staccare 		abreißen losreißen pflücken abpflügen 
stagione 		/f/-Jahreszeit Saison/f/ 
stagno 		Teich Tümpel Weiher 
stalla 		Stall 
stampare 		drucken prägen 
stancare 		strapazieren 
stanco 		matt müde 
stanza 		Wohnzimmer 
stanza 		Badestube 
stare 		hausen wohnen 
stare 		stehen 
stasera 		heute abend 
stato 		Staat 
statua 		Bildsäule Standbild Statue 
stazione 		Bahnhof 
stazione 		Badeort 
stella 		Stern 
stendardo 		Banner Fahne Standarte 
sterile 		fruchtlos steril 
stesso 		selber selbst 
stima 		Achtung Verehrung 
stimare 		achten hochschätzen 
stimolare 		anregen reizen anreizen stimulieren 
stomaco 		Magen 
storia 		Geschichte Historie 
strada 		Bahn Chaussee Strecke Weg 
strano 		befremdend kurios seltsam sonderbar wunderlich 
straordinario 		außerordentlich 
strappare 		entreißen 
stretto 		schmal 
stringere 		beklemmen drücken bedrücken pressen zwängen 
strumento 		Mittel Werkzeug 
studente 		Student 
studiare 		studieren 
stupido 		albern dumm 
stupirsi 		sich wundern staunen erstaunen 
su 		an bei zu 
subaffitto 		/m/-Untermiete/f/ 
subitaneo 		plötzlich 
subito 		alsbald flugs gleich sofort sogleich umgehend 
succedere 		geschehen passieren sich ereignen stattfinden vorkommen 
successivamente 		hinter einander 
successo 		Erfolg Gelingen 
succhiare 		lutschen saugen 
succiello 		Bohrer 
succinto 		bündig gedrängt konzis kurz 
sud 		Süden 
sudare 		schwitzen 
sufficiente 		auskömmlich genügend ziemlich zulänglich 
suffisso 		Suffix 
sughero 		Kork Pfropfen Stöpsel 
suo 		sein 
suocero 		Schwiegervater 
suonare 		spielen 
suono 		Hall Klang Laut Schall Ton 
superiore 		höher überlegen 
superstizione 		Aberglaube 
superstizioso 		abergläubisch 
supplicare 		abbetteln 
supporre 		vermuten voraussetzen 
sussurrare 		flüstern 
svedese 		Schwede 
sveglia 		Wecker 
sveglio 		anstellig behende fix geschickt geübt gewandt 
svenirsi 		in Ohnmacht fallen ohnmächtig werden 
svizzero 		Schweizer 
svoltare 		abschweifen abweichen 
s 		ja doch 
tacere 		schweigen 
tagliare 		schneiden 
tagliente 		scharf 
talento 		Talent 
tallone 		Ferse Hacke 
talvolta 		manchmal 
tanto 		sofern insofern sosehr ebensosehr soviel ebensoviel soweit 
tappeto 		Teppich 
tappezzare 		tapezieren 
tardo 		spät 
tassa 		Abgabe Steuer Steuerabgabe 
tasso 		Dachs 
tastiera 		Klaviatur Tastatur 
tavolo 		Tisch 
tazza 		Tasse 
teatro 		Theater 
tedesco 		deutsch 
tegola 		Dachziegel Pfanne Ziegel 
teiera 		Teebüchse 
temere 		fürchten befürchten sich ängsten sich ängstigen zagen 
tempesta 		Sturm 
tempia 		Schläfe 
tempo 		Zeit 
tenaglie 		Gefäß Griff Handhabe Heft Knauf Stiel 
tenebre 		Dunkelheit 
tenebroso 		dunkel finster 
tenere 		halten aufhalten 
teritorio 		Gebiet Gelände Territorium 
terminare 		beschließen enden beenden endigen beendigen erledigen 
terminato 		fertig 
terra 		Boden Erdboden Erde Grund Land Terrain 
terrazzo 		Altan Balkon 
terremoto 		Erdbeben 
terrestre 		irdisch terrestrisch 
terribile 		entsetzlich furchtbar gräßlich schrecklich 
testa 		Kopf 
tetto 		Dach 
tettoia 		Markise 
tiglio 		Linde Lindenbaum 
tigre 		/f/-Tiger/m/ 
timone 		Lenkrad 
timore 		Angst 
tinozza 		Behälter Besteck Krug 
tiranno 		Tyrann Wüterich 
tirare 		ziehen verziehen 
titubare 		schwanken zaudern zögern 
toccare 		rühren anrühren berühren tangieren 
togliere 		zurücklegen 
tollerare 		dulden 
tomo 		Band Volumen 
tonno 		Thunfisch 
topo 		/m/-Maus/f/ 
torcia 		Fackel 
toro 		Stier 
torre 		Turm Zwinger 
torta 		Kuchen 
tossire 		husten 
totale 		ganz total 
tovagliolo 		Serviette 
toviglia 		Tischtuch 
tradurre 		übersetzen übertragen 
traduzione 		Übersetzung Übertragung 
tram 		Straßenbahn 
tranquillo 		gelassen gemütlich ruhig still 
traspirare 		schwitzen 
trasportare 		befördern übertragen 
trasporto 		Transport 
trattamento 		Behandlung Unterhandlung Verhandlung 
trattare 		behandeln traktieren unterhandeln 
trattato 		Abhandlung Traktat 
trave 		Balken 
tre 		drei 
trebbiare 		dreschen 
tredici 		dreizehn 
tremare 		beben zittern zucken 
treno 		Zug 
treno 		Eilzug 
trenta 		dreißig 
triangolo 		Dreieck 
triciclo 		Dreirad 
triste 		düster 
tristezza 		Betrübnis 
tromba 		Hupe 
tronco 		Stamm Baumstamm Strunk 
troppo 		zu zu sehr zu viel 
trota 		Forelle 
trovare 		finden befinden erachten ermitteln vorfinden 
trovarsi 		sich aufhalten sich befinden 
truffa 		Betrug Täuschung Trug Unterschleif 
truffare 		äffen betrügen hintergehen täuschen 
tuo 		dein 
tuonare 		donnern 
tuono 		Donner 
turbato 		bestürtzt 
turco 		Türke 
tutto 		ganz total 
tutt 		zumeist 
t 		Tee 
ubbidiente 		folgsam fügsam gefügig gehorsam zahm 
ubbidire 		folgen befolgen gehörchen 
ubriaco 		berauscht trunken betrunken 
uccello 		/m/-Vogel/m/ 
uccidere 		ermorden töten 
udienza 		Audienz 
udire 		hören vernehmen 
udito 		Gehör 
ufficiale 		amtlich offiziell 
ufficio 		Büro Geschäftszimmer Kontor 
ufficio 		Auskunftstelle 
ufficio 		Postamt 
uffizio 		Gottesdienst 
ultimo 		letzte letzter letztes 
umile 		demütig kleinlaut unterwürfig 
un 		ein eine eins 
una 		ein eine eins 
una 		einmal 
undici 		elf 
ungherese 		Ungar 
unghia 		Nagel 
unico 		einzig 
unit 		Einigkeit Einheit 
universale 		universal 
universit 		Hochschule Universität 
uno 		ein eine eins 
un 		ein eine eins 
uomo 		Mann 
uovo 		Ei 
urto 		Stoß Trieb 
usare 		anwenden benutzen brauchen gebrauchen verwenden verwerten 
uscio 		Tür 
uscire 		ausgehen ausrücken 
uscita 		Ausgang 
usignolo 		Nachtigall 
usignuolo 		Nachtigall 
uso 		Benutzung Gebrauch 
usuale 		geläufig üblich 
utile 		nützlich vorteilhaft zweckdienlich 
utilizzare 		dienen frommen nützen 
uva 		Traube Weintraube 
vacca 		Kuh 
vagone 		Bahnwagen Wagen Wagon Waggon 
valere 		aufwiegen gelten sich verlohnen wert sein 
valigia 		Handkoffer Felleisen 
valle 		Tal 
valore 		Bedeutung Geltung Wert 
valutare 		abschätzen bewerten schätzen abschätzen einschätzen 
valvola 		Ventil 
vangelo 		Evangelium 
vanitoso 		eitel hinfällig 
vantaggio 		Ertrag Gewinn Interesse Nutzen Überschuß Verdienst Vorteil 
variazone 		Variation 
vasca 		Bad 
vaso 		Behälter Besteck Krug 
vaso 		Blumentopf 
vecchio 		alt bejahrt betagt 
vedere 		sehen ansehen 
vela 		Segel 
veleno 		Gift 
velenoso 		giftig 
velocit 		Geschwindigkeit Tempo 
vena 		Ader Vene 
vendere 		veräußern verkaufen 
vendetta 		Rache 
vendita 		Absatz Debit Vertrieb 
venerare 		anbeten verehren vergöttern 
venerd 		Freitag/m/ 
venire 		kommen 
venti 		zwanzig 
ventilare 		lüften 
vento 		Wind 
ventre 		Bauch Unterleib 
venuta 		Ankunft Eintreffen 
verde 		grün 
vergognarsi 		sich schämen 
verificare 		kontrollieren nachsehen überwachen 
verit 		Wahrheit 
verme 		Wurm 
vero 		authentisch echt recht urkundlich wahr wahrhaft 
versare 		gießen schütten 
verso 		annähernd etwa ungefähr 
vescica 		Blase 
vescovo 		Bischof 
vespa 		/f/-Wespe/f/ 
vestire 		anziehen kleiden ankleiden bekleiden 
vetro 		Glas 
vettura 		Bahnwagen Wagen Wagon Waggon 
vettura 		Schlafwagen 
via 		Straße 
viaggiare 		reisen 
viaggio 		Reise Tour 
vicino 		angrenzend anstoßend benachbart 
vicolo 		Gasse 
vietare 		untersagen verbieten 
vigna 		Weinberg 
villaggio 		Dorf Ort 
vino 		Wein 
violoncello 		Violincello 
vipera 		Natter 
virt 		Tugend 
visita 		Besuch Visite 
visitare 		besuchen einen Besuch abstatten 
viso 		Angesicht Antlitz Gesicht 
vista 		Aussicht 
visto 		da denn weil 
vita 		Leben 
vite 		Rebe Weinstock 
vitello 		Kalb 
vittoria 		Triumph 
vivere 		leben 
volante 		Lenkrad 
volare 		fliegen huschen 
volentieri 		bereit bereitwillig gern 
volere 		wollen 
volere 		gern haben lieben mögen 
volgare 		üblich verständlich vulgär 
volont 		Wille 
volpe 		/f/-Fuchs/m/ 
volume 		Band Volumen 
vomitare 		sich brechen sich erbrechen sich übergeben 
vongola 		Miesmuschel 
vostro 		dein deinig euer eurige Ihr ihrige 
votare 		votieren 
vuotare 		ausleeren entleeren 
vuoto 		leer 
zanzara 		/f/-Mücke/f/ Stechmücke/f/ Moskito 
zavorra 		Ballast 
zelo 		Eifer Inbrunst 
zio 		Onkel 
zoccolo 		Huf 
zodiaco 		Tierkreis Zodiakus 
zoppicare 		hinken humpeln 
zucca 		Kürbis 
