Norbert Wiener, a key figure in cybernetics, in which Weaver made this curious claim, today quite famous:
    When I look at an article in Russian, I say, â€œThis is really written in English, but it has been coded in some strange symbols. I will now proceed to decode.â€


Ğ³ -> gh  buchĞ³altung Ğ³aaĞ³a = Hague
Ñ„ => PTH!!! ph/th!! arithmetic Ğ°Ñ€Ğ¸Ñ„Ğ¼ĞµÑ‚Ğ¸ĞºĞ° Athens F france  amphibian  Ğ°Ğ¼Ñ„Ğ¸Ğ±Ğ¸Ñ  âœ“ ĞÑ„Ñ€Ğ¸ĞºĞ° Ğ­Ñ„Ğ¸Ğ¾Ğ¿Ğ¸Ñ Ethiopia Ğ¿Ñ€Ğ¾Ñ„ĞµÑÑĞ¾Ñ€ 
Ñƒ = u â‰  vy (historic) phui
Ğ¹ : Ã±y->y ng/nik/ing->y !  blank 		Ğ±ĞµĞ»Ñ‹Ğ¹  belÄ—iy[nk]  âœ“
Ğ® : U (iUv) new Luxemburg Ğ®Ğ³Ğ¾ÑĞ»Ğ°Ğ²Ğ¸Ñ  Yugoslaviia
professor
-nost -ness
Ğ±ĞµĞ³- WEG-! => Ğ±Ğµs des-
Ğ¾Ñ‚- o- aus- :(?): re- er- wieder-?
Ğ·Ğ°- zu- fÃ¼r-

k c zu to !  K/T !  kata? tak?

zoo 		Ğ·Ğ¾Ğ¾Ğ¿Ğ°Ñ€Ğº  Å›oopark âœ“
ABC 		Ğ°Ğ·Ğ±ÑƒĞºĞ° Ğ°Ğ»Ñ„Ğ°Ğ²Ğ¸Ñ‚  acbuca alphabet : abc âœ“ al'tablet
Abyssinia 		Ğ­Ñ„Ğ¸Ğ¾Ğ¿Ğ¸Ñ  aithiopiia âœ“
Adam's apple 		Ğ°Ğ´Ğ°Ğ¼Ğ¾Ğ²Ğ¾ ÑĞ±Ğ»Ğ¾ĞºĞ¾  adamovo iabloko âœ“
Addis Ababa 		ĞĞ´Ğ´Ğ¸Ñâ€ĞĞ±ĞµĞ±Ğ°  addisâ€abeba  âœ“
Aden 		ĞĞ´ĞµĞ½  aden  âœ“
Afghanistan 		ĞÑ„Ğ³Ğ°Ğ½Ğ¸ÑÑ‚Ğ°Ğ½  afganistan  âœ“
Africa 		ĞÑ„Ñ€Ğ¸ĞºĞ°  afrika  âœ“ Ñ„!
African 		Ğ°Ñ„Ñ€Ğ¸ĞºĞ°Ğ½ĞµÑ†  afthrikaness âœ“
African woman 		Ğ°Ñ„Ñ€Ğ¸ĞºĞ°Ğ½ĞºĞ°  afthrikanka âœ“
Albania 		ĞĞ»Ğ±Ğ°Ğ½Ğ¸Ñ  albaniia  âœ“
Algeria 		ĞĞ»Ğ¶Ğ¸Ñ€  alÎ¶eir  âœ“
Algiers 		ĞĞ»Ğ¶Ğ¸Ñ€  alÎ¶eir  âœ“
Alps 		ĞĞ»ÑŒĞ¿Ñ‹  alpÄ—i  âœ“
Altai 		ĞĞ»Ñ‚Ğ°Ğ¹  altay  âœ“
America 		ĞĞ¼ĞµÑ€Ğ¸ĞºĞ°  amerika  âœ“
American 		Ğ°Ğ¼ĞµÑ€Ğ¸ĞºĞ°Ğ½ÑĞºĞ¸Ğ¹  amerikanskiy 
American woman 		Ğ°Ğ¼ĞµÑ€Ğ¸ĞºĞ°Ğ½ĞºĞ°  amerikanka  âœ“
Amsterdam 		ĞĞ¼ÑÑ‚ĞµÑ€Ğ´Ğ°Ğ¼  amsterdam  âœ“
Amudaryra 		ĞĞ¼ÑƒĞ´Ğ°Ñ€ÑŒÑ  amudaria  âœ“
Amur 		ĞĞ¼ÑƒÑ€  amur  âœ“
Angola 		ĞĞ½Ğ³Ğ¾Ğ»Ğ°  angola  âœ“
Angora 		ĞĞ½ĞºĞ°Ñ€Ğ°  ankara  âœ“
Ankara 		ĞĞ½ĞºĞ°Ñ€Ğ°  ankara  âœ“
Antarctic 		ĞĞ½Ñ‚Ğ°Ñ€ĞºÑ‚Ğ¸ĞºĞ°  antarktika  âœ“
Antwerp 		ĞĞ½Ñ‚Ğ²ĞµÑ€Ğ¿ĞµĞ½  antverpen  âœ“
April 		Ğ°Ğ¿Ñ€ĞµĞ»ÑŒ  aprel  âœ“
Arab 		Ğ°Ñ€Ğ°Ğ±  arab  âœ“
Arabia 		ĞÑ€Ğ°Ğ±Ğ¸Ñ  arabiia  âœ“
Arabian 		Ğ°Ñ€Ğ°Ğ±ÑĞºĞ¸Ğ¹  arabskiy  âœ“
Arabian woman 		Ğ°Ñ€Ğ°Ğ±ĞºĞ°  arabka âœ“
Arabic 		Ğ°Ñ€Ğ°Ğ±ÑĞºĞ¸Ğ¹  arabskiy  âœ“
Aral Sea 		ĞÑ€Ğ°Ğ»ÑŒÑĞºĞ¾Ğµ Ğ¼Ğ¾Ñ€Ğµ  aralskoe more âœ“
Archangel 		ĞÑ€Ñ…Ğ°Ğ½Ğ³ĞµĞ»ÑŒÑĞº  arxangelsk  âœ“
Argentina 		ĞÑ€Ğ³ĞµĞ½Ñ‚Ğ¸Ğ½Ğ°  argentina  âœ“
Armenia 		ĞÑ€Ğ¼ĞµĞ½Ğ¸Ñ  armeniia  âœ“
Arnhem 		ĞÑ€Ğ½ĞµĞ¼  arnem  âœ“
Asia 		ĞĞ·Ğ¸Ñ  aÅ›iia âœ“
Asian 		Ğ°Ğ·Ğ¸Ğ°Ñ‚ÑĞºĞ¸Ğ¹  aÅ›iatskiy âœ“
Asian woman 		Ğ°Ğ·Ğ¸Ğ°Ñ‚ĞºĞ°  aÅ›iatka âœ“
Asiatic 		Ğ°Ğ·Ğ¸Ğ°Ñ‚ÑĞºĞ¸Ğ¹  aÅ›iatskiy âœ“
Athena 		ĞÑ„Ğ¸Ğ½Ñ‹  athinÄ—i  âœ“
Athene 		ĞÑ„Ğ¸Ğ½Ñ‹  afthinÄ—i  âœ“ Ñ„ Apth!
Athenian 		Ğ°Ñ„Ğ¸Ğ½ÑĞºĞ¸Ğ¹  athinskiy âœ“
Athens 		ĞÑ„Ğ¸Ğ½Ñ‹  athinÄ—i  âœ“
Atlantic 		ĞÑ‚Ğ»Ğ°Ğ½Ñ‚Ğ¸Ñ‡ĞµÑĞºĞ¸Ğ¹ Ğ¾ĞºĞµĞ°Ğ½  atlanticheskiy okean âœ“
Atlantic Ocean 		ĞÑ‚Ğ»Ğ°Ğ½Ñ‚Ğ¸Ñ‡ĞµÑĞºĞ¸Ğ¹ Ğ¾ĞºĞµĞ°Ğ½  atlanticheskiy okean âœ“
August 		Ğ°Ğ²Ğ³ÑƒÑÑ‚  avgust  âœ“
Australia 		ĞĞ²ÑÑ‚Ñ€Ğ°Ğ»Ğ¸Ñ  avstraliia  âœ“
Australian 		Ğ°Ğ²ÑÑ‚Ñ€Ğ°Ğ»Ğ¸Ğ¹ÑĞºĞ¸Ğ¹  avstraliyskiy 
Australian woman 		Ğ°Ğ²ÑÑ‚Ñ€Ğ°Ğ»Ğ¸Ğ¹ĞºĞ°  avstraliyka  âœ“
Austrian 		Ğ°Ğ²ÑÑ‚Ñ€Ğ¸Ğ¹ÑĞºĞ¸Ğ¹  avstriyskiy âœ“
Azerbaijan 		ĞĞ·ĞµÑ€Ğ±Ğ°Ğ¹Ğ´Ğ¶Ğ°Ğ½  aÅ›erbaydÎ¶ean âœ“
Baghdad 		Ğ‘Ğ°Ğ³Ğ´Ğ°Ğ´  bagdad  âœ“
Baikal 		Ğ‘Ğ°Ğ¹ĞºĞ°Ğ»  baykal  âœ“
Baku 		Ğ‘Ğ°ĞºÑƒ  baku  âœ“
Balkans 		Ğ‘Ğ°Ğ»ĞºĞ°Ğ½Ñ‹  balkanÄ—i  âœ“
Bangladesh 		Ğ‘Ğ°Ğ½Ğ³Ğ»Ğ°Ğ´ĞµÑˆ  bangladesh  âœ“
Belgian 		Ğ±ĞµĞ»ÑŒĞ³Ğ¸Ğ¹ÑĞºĞ¸Ğ¹  belgiyskiy 
Belgian woman 		Ğ±ĞµĞ»ÑŒĞ³Ğ¸Ğ¹ĞºĞ°  belgiyka  âœ“
Belgrade 		Ğ‘ĞµĞ»Ğ³Ñ€Ğ°Ğ´  belgrad  âœ“
Bering Sea 		Ğ‘ĞµÑ€Ğ¸Ğ½Ğ³Ğ¾Ğ²Ğ¾ Ğ¼Ğ¾Ñ€Ğµ  beringovo more âœ“
Berlin 		Ğ‘ĞµÑ€Ğ»Ğ¸Ğ½  berlin  âœ“
Beyrouth 		Ğ‘ĞµĞ¹Ñ€ÑƒÑ‚  beyrut  âœ“
Boisâ€leâ€Duc 		Ğ¥ĞµÑ€Ñ‚Ğ¾Ğ³ĞµĞ½Ğ±Ğ¾Ñ  xertogenbos ?/
Bolivia 		Ğ‘Ğ¾Ğ»Ğ¸Ğ²Ğ¸Ñ  boliviia  âœ“
Bombay 		Ğ‘Ğ¾Ğ¼Ğ±ĞµĞ¹  bombey  âœ“
Bonn 		Ğ‘Ğ¾Ğ½Ğ½  bonn  âœ“
Brabant 		Ğ‘Ñ€Ğ°Ğ±Ğ°Ğ½Ñ‚  brabant  âœ“
Braille 		Ğ°Ğ·Ğ±ÑƒĞºĞ° Ğ´Ğ»Ñ ÑĞ»ĞµĞ¿Ñ‹Ñ…  aÅ›buka dlia slepÄ—ix /?
Brazil 		Ğ‘Ñ€Ğ°Ğ·Ğ¸Ğ»Ğ¸Ñ  braÅ›iliia âœ“
Brest 		Ğ‘Ñ€ĞµÑÑ‚  brest  âœ“
Britain 		Ğ’ĞµĞ»Ğ¸ĞºĞ¾Ğ±Ñ€Ğ¸Ñ‚Ğ°Ğ½Ğ¸Ñ  veliko=great britaniia 
British 		Ğ±Ñ€Ğ¸Ñ‚Ğ°Ğ½ÑĞºĞ¸Ğ¹  britanskiy âœ“
Brussels 		Ğ‘Ñ€ÑÑÑĞµĞ»ÑŒ  brussel  âœ“
Bucharest 		Ğ‘ÑƒÑ…Ğ°Ñ€ĞµÑÑ‚  buxarest  âœ“
Bulgar 		Ğ±Ğ¾Ğ»Ğ³Ğ°Ñ€Ğ¸Ğ½  bolgarin  âœ“
Bulgaria 		Ğ‘Ğ¾Ğ»Ğ³Ğ°Ñ€Ğ¸Ñ  bolgariia  âœ“
Bulgarian 		Ğ±Ğ¾Ğ»Ğ³Ğ°Ñ€ÑĞºĞ¸Ğ¹  bolgarskiy  âœ“
Bulgarian woman 		Ğ±Ğ¾Ğ»Ğ³Ğ°Ñ€ĞºĞ°  bolgarka âœ“
Burma 		Ğ‘Ğ¸Ñ€Ğ¼Ğ°  birma  âœ“
Cairo 		ĞšĞ°Ğ¸Ñ€  kair  âœ“
Calcutta 		ĞšĞ°Ğ»ÑŒĞºÑƒÑ‚Ñ‚Ğ°  kalkutta  âœ“
Cambodia 		ĞšĞ°Ğ¼Ğ¿ÑƒÑ‡Ğ¸Ñ  kampuchiia âœ“
Cameroon 		ĞšĞ°Ğ¼ĞµÑ€ÑƒĞ½  kamerun  âœ“
Canada 		ĞšĞ°Ğ½Ğ°Ğ´Ğ°  kanada  âœ“
Canberra 		ĞšĞ°Ğ½Ğ±ĞµÑ€Ñ€Ğ°  kanberra  âœ“
Carpathians 		ĞšĞ°Ñ€Ğ¿Ğ°Ñ‚ÑĞºĞ¸Ğµ Ğ³Ğ¾Ñ€Ñ‹ ĞšĞ°Ñ€Ğ¿Ğ°Ñ‚Ñ‹  karpatskie gorÄ—i karpatÄ—i 
Carpathian mountains 		ĞšĞ°Ñ€Ğ¿Ğ°Ñ‚ÑĞºĞ¸Ğµ Ğ³Ğ¾Ñ€Ñ‹ ĞšĞ°Ñ€Ğ¿Ğ°Ñ‚Ñ‹  karpatskie gorÄ—i karpatÄ—i 
Caucasus 		ĞšĞ°Ğ²ĞºĞ°Ğ·  kavkaÅ› âœ“
Channel 		Ğ›Ğ°â€ĞœĞ°Ğ½Ñˆ  laâ€mansh <<< 
Chile 		Ğ§Ğ¸Ğ»Ğ¸  dhili  âœ“
China 		ĞšĞ¸Ñ‚Ğ°Ğ¹  kitay  âœ“
Congo 		ĞšĞ¾Ğ½Ğ³Ğ¾  kongo  âœ“
Copenhagen 		ĞšĞ¾Ğ¿ĞµĞ½Ğ³Ğ°Ğ³ĞµĞ½  kopengagen  âœ“
Cuba 		ĞšÑƒĞ±Ğ°  kuba  âœ“
CuraÃ§ao 		ĞšÑÑ€Ğ°ÑĞ°Ğ¾  kurasao  âœ“
Cyprus 		ĞšĞ¸Ğ¿Ñ€  kipr  âœ“
Dacca 		Ğ”Ğ°ĞºĞºĞ°  dakka  âœ“
Dakar 		Ğ”Ğ°ĞºĞ°Ñ€  dakar  âœ“
Damascus 		Ğ”Ğ°Ğ¼Ğ°ÑĞº  damask  âœ“
Danube 		Ğ”ÑƒĞ½Ğ°Ğ¹  dunay âœ“ 
Delft 		Ğ”ĞµĞ»Ñ„Ñ‚  delftht  âœ“
Denmark 		Ğ”Ğ°Ğ½Ğ¸Ñ  daniia 
Dnieper 		Ğ”Ğ½ĞµĞ¿Ñ€  dnepr  âœ“
Dominican Republic 		Ğ”Ğ¾Ğ¼Ğ¸Ğ½Ğ¸ĞºĞ°Ğ½ÑĞºĞ°Ñ Ğ ĞµÑĞ¿ÑƒĞ±Ğ»Ğ¸ĞºĞ°  dominikanskaia respublika âœ“
Don Juan 		Ğ±Ğ°Ğ±Ğ½Ğ¸Ğº  babnik ?/
Dublin 		Ğ”ÑƒĞ±Ğ»Ğ¸Ğ½  dublin  âœ“

East 		Ğ²Ğ¾ÑÑ‚Ğ¾Ğº  vostok Veast! <<

Egypt 		Ğ•Ğ³Ğ¸Ğ¿ĞµÑ‚  egipet  âœ“
England 		ĞĞ½Ğ³Ğ»Ğ¸Ñ  angliia  âœ“
English 		Ğ°Ğ½Ğ³Ğ»Ğ¸Ğ¹ÑĞºĞ¸Ğ¹  angliyskiy  âœ“
Englishman 		Ğ°Ğ½Ğ³Ğ»Ğ¸Ñ‡Ğ°Ğ½Ğ¸Ğ½  anglichanin  âœ“
Englishwoman 		Ğ°Ğ½Ğ³Ğ»Ğ¸Ñ‡Ğ°Ğ½ĞºĞ°  anglichanka  âœ“
English Channel 		Ğ›Ğ°â€ĞœĞ°Ğ½Ñˆ  laâ€mansh << Isle of Man?
Esperanto 		ÑÑĞ¿ĞµÑ€Ğ°Ğ½Ñ‚Ğ¾  aisperanto  âœ“
Estonia 		Ğ­ÑÑ‚Ğ¾Ğ½Ğ¸Ñ  aistoniia  âœ“
Ethiopia 		Ğ­Ñ„Ğ¸Ğ¾Ğ¿Ğ¸Ñ  aithiopiia  âœ“
Europa 		Ğ•Ğ²Ñ€Ğ¾Ğ¿Ğ°  evropa  âœ“
Europe 		Ğ•Ğ²Ñ€Ğ¾Ğ¿Ğ°  evropa  âœ“

France 		Ğ¤Ñ€Ğ°Ğ½Ñ†Ğ¸Ñ  Franssiia !!!
French 		Ñ„Ñ€Ğ°Ğ½Ñ†ÑƒĞ·ÑĞºĞ¸Ğ¹  FthranssuÅ›skiy !!!

Friesland 		Ğ¤Ñ€Ğ¸ÑĞ»Ğ°Ğ½Ğ´Ğ¸Ñ  Frislandiia  âœ“
Gabon 		Ğ“Ğ°Ğ±Ğ¾Ğ½  gabon  âœ“
Gambia 		Ğ“Ğ°Ğ¼Ğ±Ğ¸Ñ  gambiia  âœ“

Genesis 		ĞºĞ½Ğ¸Ğ³Ğ° Ğ‘Ñ‹Ñ‚Ğ¸Ñ  kniga bÄ—itiia <<

Geneva 		Ğ–ĞµĞ½ĞµĞ²Ğ°  Î¶eeneva  âœ“
Genoa 		Ğ“ĞµĞ½ÑƒÑ  genuia  âœ“
Georgia 		Ğ“Ñ€ÑƒĞ·Ğ¸Ñ  gruÅ›iia ~âœ“

Germany 		Ğ“ĞµÑ€Ğ¼Ğ°Ğ½Ğ¸Ñ  germaniia  âœ“
German 		Ğ½ĞµĞ¼ĞµÑ†ĞºĞ¸Ğ¹  nemesskiy <<

Ghana 		Ğ“Ğ°Ğ½Ğ°  gana  âœ“
God 		Ğ‘Ğ¾Ğ³  bog  âœ“
Great Britain 		Ğ’ĞµĞ»Ğ¸ĞºĞ¾Ğ±Ñ€Ğ¸Ñ‚Ğ°Ğ½Ğ¸Ñ  veliko britaniia âœ“ ! ver!
Greece 		Ğ“Ñ€ĞµÑ†Ğ¸Ñ  gressiia âœ“
Greenland 		Ğ“Ñ€ĞµĞ½Ğ»Ğ°Ğ½Ğ´Ğ¸Ñ  grenlandiia  âœ“
Guinea 		Ğ“Ğ²Ğ¸Ğ½ĞµÑ  gvineia  âœ“
Guinea Bissau 		Ğ“Ğ²Ğ¸Ğ½ĞµÑâ€Ğ‘Ğ¸ÑĞ°Ñƒ  gvineiaâ€bisau  âœ“
Gulf of Finland 		Ğ¤Ğ¸Ğ½ÑĞºĞ¸Ğ¹ Ğ·Ğ°Ğ»Ğ¸Ğ²  Finskiy Å›aliv ?
Haiti 		Ğ“Ğ°Ğ¸Ñ‚Ğ¸  gaiti  âœ“!
Hanoi 		Ğ¥Ğ°Ğ½Ğ¾Ğ¹  xanoy  âœ“
Havana 		Ğ“Ğ°Ğ²Ğ°Ğ½Ğ°  gavana  âœ“
Helsinki 		Ğ¥ĞµĞ»ÑŒÑĞ¸Ğ½ĞºĞ¸  xelsinki  âœ“
Holland 		Ğ“Ğ¾Ğ»Ğ»Ğ°Ğ½Ğ´Ğ¸Ñ  gollandiia  âœ“
Hook of Holland 		Ğ¥ÑƒĞºĞ²Ğ°Ğ½ Ğ¥Ğ¾Ğ»Ğ»Ğ°Ğ½Ğ´  xukvan xolland  âœ“

Hungary 		Ğ’ĞµĞ½Ğ³Ñ€Ğ¸Ñ  vengriia âœ“ !! VANgaria <<< !!!

Iceland 		Ğ˜ÑĞ»Ğ°Ğ½Ğ´Ğ¸Ñ  islandiia âœ“
India 		Ğ˜Ğ½Ğ´Ğ¸Ñ  indiia  âœ“
Indian Ocean 		Ğ˜Ğ½Ğ´Ğ¸Ğ¹ÑĞºĞ¸Ğ¹ Ğ¾ĞºĞµĞ°Ğ½  indiyskiy okean âœ“
Indonesia 		Ğ˜Ğ½Ğ´Ğ¾Ğ½ĞµĞ·Ğ¸Ñ  indoneÅ›iia  âœ“
Iran 		Ğ˜Ñ€Ğ°Ğ½  iran  âœ“
Iraq 		Ğ˜Ñ€Ğ°Ğº  irak  âœ“
Ireland 		Ğ˜Ñ€Ğ»Ğ°Ğ½Ğ´Ğ¸Ñ  irlandiia  âœ“
Israel 		Ğ˜Ğ·Ñ€Ğ°Ğ¸Ğ»ÑŒ  iÅ›rail  âœ“
Italy 		Ğ˜Ñ‚Ğ°Ğ»Ğ¸Ñ  italiia  âœ“
Jamaica 		Ğ¯Ğ¼Ğ°Ğ¹ĞºĞ°  iamayka  âœ“
Japan 		Ğ¯Ğ¿Ğ¾Ğ½Ğ¸Ñ  iaponiia âœ“
Jordan 		Ğ˜Ğ¾Ñ€Ğ´Ğ°Ğ½Ğ¸Ñ  iordaniia  âœ“
June 		Ğ¸ÑĞ½ÑŒ  iun  âœ“ !
Kabul 		ĞšĞ°Ğ±ÑƒĞ»  kabul  âœ“
Kazakhstan 		ĞšĞ°Ğ·Ğ°Ñ…ÑÑ‚Ğ°Ğ½  kaÅ›axstan  âœ“
Kieff 		ĞšĞ¸ĞµĞ²  kiev  âœ“
Kirghizia 		ĞšĞ¸Ñ€Ğ³Ğ¸Ğ·Ğ¸Ñ  kirgiÅ›iia  âœ“
Korea 		ĞšĞ¾Ñ€ĞµÑ  koreia  âœ“
Laos 		Ğ›Ğ°Ğ¾Ñ  laos  âœ“
Latvia 		Ğ›Ğ°Ñ‚Ğ²Ğ¸Ñ  latviia  âœ“
Lebanon 		Ğ›Ğ¸Ğ²Ğ°Ğ½  livan  âœ“
Leyden 		Ğ›ĞµĞ¹Ğ´ĞµĞ½  leyden  âœ“
Liberia 		Ğ›Ğ¸Ğ±ĞµÑ€Ğ¸Ñ  liberiia  âœ“
Libya 		Ğ›Ğ¸Ğ²Ğ¸Ñ  liviia  âœ“
Lisbon 		Ğ›Ğ¸ÑÑĞ°Ğ±Ğ¾Ğ½  lissabon  âœ“
Lithuania 		Ğ›Ğ¸Ñ‚Ğ²Ğ°  litva  âœ“
Liverpool 		Ğ›Ğ¸Ğ²ĞµÑ€Ğ¿ÑƒĞ»ÑŒ  liverpul  âœ“
London 		Ğ›Ğ¾Ğ½Ğ´Ğ¾Ğ½  london  âœ“
Luxemburg 		Ğ›ÑĞºÑĞµĞ¼Ğ±ÑƒÑ€Ğ³  luksemburg  âœ“
Madrid 		ĞœĞ°Ğ´Ñ€Ğ¸Ğ´  madrid  âœ“
Maestricht 		ĞœĞ°Ğ°ÑÑ‚Ñ€Ğ¸Ñ…Ñ‚  maastrixt  âœ“
Malaysia 		ĞœĞ°Ğ»Ğ°Ğ¹Ğ·Ğ¸Ñ  malayÅ›iia  âœ“
Mali 		ĞœĞ°Ğ»Ğ¸  mali  âœ“

Mediterranean 		Ğ¡Ñ€ĞµĞ´Ğ¸Ğ·ĞµĞ¼Ğ½Ğ¾Ğµ Ğ¼Ğ¾Ñ€Ğµ  srediÅ›emnoe more <<

Meuse 		ĞœĞ°Ğ°Ñ  maas  âœ“
Mexico 		ĞœĞµĞºÑĞ¸ĞºĞ°  meksika 
Mexico City 		ĞœĞµÑ…Ğ¸ĞºĞ¾  mexiko  âœ“
Minsk 		ĞœĞ¸Ğ½ÑĞº  minsk  âœ“
Moldavia 		ĞœĞ¾Ğ»Ğ´Ğ°Ğ²Ğ¸Ñ  moldaviia  âœ“
Monaco 		ĞœĞ¾Ğ½Ğ°ĞºĞ¾  monako  âœ“
Mongolia 		ĞœĞ¾Ğ½Ğ³Ğ¾Ğ»Ğ¸Ñ  mongoliia  âœ“
Morse alphabet 		Ğ°Ğ·Ğ±ÑƒĞºĞ° Ğ¼Ğ¾Ñ€Ğ·Ğµ  aÅ›buka morÅ›e âœ“
Moscow 		ĞœĞ¾ÑĞºĞ²Ğ°  moskva  âœ“
Mozambique 		ĞœĞ¾Ğ·Ğ°Ğ¼Ğ±Ğ¸Ğº  moÅ›ambik  âœ“
Nepal 		ĞĞµĞ¿Ğ°Ğ»  nepal  âœ“
New York City 		ĞÑŒÑâ€Ğ™Ğ¾Ñ€Ğº  nuvâ€York 
New Amsterdam 		ĞÑŒÑâ€Ğ™Ğ¾Ñ€Ğº  nuvâ€hnork 
New York 		ĞÑŒÑâ€Ğ™Ğ¾Ñ€Ğº  nuvâ€hnork  âœ“
Nicosia 		ĞĞ¸ĞºĞ¾ÑĞ¸Ñ  nikosiia  âœ“

North 		ÑĞµĞ²ĞµÑ€  sever  Sibir! âœ“ <<< +++

Oxus 		ĞĞ¼ÑƒĞ´Ğ°Ñ€ÑŒÑ  amudaria âœ“ !!
Persia 		Ğ˜Ñ€Ğ°Ğ½  iran âœ“
Rhine barge 		Ğ±Ğ°Ñ€Ğ¶Ğ°  barÎ¶ea ?
Russia 		Ğ Ğ¾ÑÑĞ¸Ñ  rossiia  âœ“
Russian 		Ñ€ÑƒÑÑĞºĞ¸Ğ¹  russkiy  âœ“
Sassenach 		Ğ°Ğ½Ğ³Ğ»Ğ¸Ñ‡Ğ°Ğ½Ğ¸Ğ½  anglichanin âœ“   (?)

Saturday 		ÑÑƒĞ±Ğ±Ğ¾Ñ‚Ğ°  subbota âœ“

Sea of Laptev 		Ğ¼Ğ¾Ñ€Ğµ Ğ›Ğ°Ğ¿Ñ‚ĞµĞ²Ñ‹Ñ…  more laptevÄ—ix âœ“
Soviet 		ÑĞ¾Ğ²ĞµÑ‚ÑĞºĞ¸Ğ¹  sovetskiy âœ“

Street of Dover 		ĞŸĞ°â€Ğ´Ğµâ€ĞšĞ°Ğ»Ğµ  paâ€deâ€kale <<

The Hague 		Ğ“Ğ°Ğ°Ğ³Ğ°  gaaga âœ“ :) LOL
US citizen 		Ğ°Ğ¼ĞµÑ€Ğ¸ĞºĞ°Ğ½ĞµÑ†  amerikaness âœ“
Volga 		Ğ’Ğ¾Ğ»Ğ³Ğ°  volga  âœ“
White Russia 		Ğ‘ĞµĞ»Ğ¾Ñ€ÑƒÑÑĞ¸Ñ  belorussiia âœ“
Yalta 		Ğ¯Ğ»Ñ‚Ğ°  ialta  âœ“
Yemen 		Ğ™ĞµĞ¼ĞµĞ½  hnemen  âœ“
Yugoslavia 		Ğ®Ğ³Ğ¾ÑĞ»Ğ°Ğ²Ğ¸Ñ  Yugoslaviia  âœ“
Zaire 		ĞšĞ¾Ğ½Ğ³Ğ¾  kongo âœ“

a 		Ğ² Ğ½Ğ°  v na <<?

abattoir 		Ğ±Ğ¾Ğ¹Ğ½Ñ  boynia banjo:bath

abdomen 		Ğ±Ñ€ÑÑ…Ğ¾  bruxo  bronche? ~âœ“â„¢
abdominal 		Ğ±Ñ€ÑÑˆĞ½Ğ¾Ğ¹  brushnoy Brust++ âœ“

aberration 		Ğ¾ÑˆĞ¸Ğ±ĞºĞ°  oshibka 
able 		ÑĞ¿Ğ¾ÑĞ¾Ğ±Ğ½Ñ‹Ğ¹  sposobnÄ—iy ~~ Ğ¿Ğ¾ÑĞ¾Ğ± : potent -
abide 		Ğ¶Ğ´Ğ°Ñ‚ÑŒ Ğ¿Ğ¾Ğ´Ğ¾Ğ¶Ğ´Ğ°Ñ‚ÑŒ  Î¶edat ~ stay- podoÎ¶edat 
abortive 		Ğ±ĞµÑĞ¿Ğ¾Ğ»ĞµĞ·Ğ½Ñ‹Ğ¹  bes.poleÅ›nÄ—iy unnÃ¼Å›,unnÃ¶tig â€¦

about 		Ğ¾  o  âœ“
above 		Ğ½Ğ°Ğ´  nad  nach,an+at,Ã¼ber    	Ğ´ÑƒÌĞ¼Ğ°Ñ‚ÑŒuv (Ğ½Ğ°Ğ´ Ñ‡ĞµĞ¼) nach-denken Ã¼ber etwas/jemand

abroad 		Ğ·Ğ° Ğ³Ñ€Ğ°Ğ½Ğ¸Ñ†ĞµĞ¹  Å›a granissey  zu Grenze +++ <<

abscess 		Ğ°Ğ±ÑÑ†ĞµÑÑ  absssess  âœ“
absent 		Ğ¾Ñ‚ÑÑƒÑ‚ÑÑ‚Ğ²ÑƒÑÑ‰Ğ¸Ğ¹  otsutstvuÑschiy  otsut~absent +-
absolute 		Ğ±ĞµĞ·Ğ³Ñ€Ğ°Ğ½Ğ¸Ñ‡Ğ½Ñ‹Ğ¹ Ğ±ĞµĞ·Ğ·Ğ°Ğ²ĞµÑ‚Ğ½Ñ‹Ğ¹ Ğ±ĞµÑĞºÑ€Ğ°Ğ¹Ğ½Ñ‹Ğ¹ Ğ±ĞµÑĞ¿Ñ€ĞµĞ´ĞµĞ»ÑŒĞ½Ñ‹Ğ¹  Ğ±ĞµÅ›-granichnÄ—iy Ğ±ĞµÅ›-Å›avetnÄ—iy beskraynÄ—iy bespredelnÄ—iy 
absolutely 		Ğ°Ğ±ÑĞ¾Ğ»ÑÑ‚Ğ½Ğ¾  absolutno  âœ“

abstract 		Ğ·Ğ°Ğ±Ğ¸Ñ€Ğ°Ñ‚ÑŒ Ğ·Ğ°Ğ±Ñ€Ğ°Ñ‚ÑŒ  Å›abirat zu-fÃ¼hren â€¦ berÃ¼hren â„¢ ... --

absurdity 		Ğ°Ğ±ÑÑƒÑ€Ğ´  absurd  âœ“
abundance 		Ğ±Ğ¾Ğ³Ğ°Ñ‚ÑÑ‚Ğ²Ğ¾  bogatstvo   bogota;) <<
abysmal 		Ğ±ĞµĞ·Ğ²Ñ‹Ñ…Ğ¾Ğ´Ğ½Ñ‹Ğ¹ Ğ±ĞµĞ·Ğ½Ğ°Ğ´Ñ‘Ğ¶Ğ½Ñ‹Ğ¹ Ğ±ĞµĞ·Ñ‹ÑÑ…Ğ¾Ğ´Ğ½Ñ‹Ğ¹  Ğ±ĞµÅ›-vÄ—ixodnÄ—iy Ğ±ĞµÅ›-nadÑ‘Î¶enÄ—iy Ğ±ĞµÅ›-Ä—isxodnÄ—iy 
abyss 		Ğ±ĞµĞ·Ğ´Ğ½Ğ°  (a)Ğ±ĞµÅ›-dna  âœ“ - ?
academic 		Ğ°ĞºĞ°Ğ´ĞµĞ¼Ğ¸Ñ‡ĞµÑĞºĞ¸Ğ¹  akademicheskiy âœ“
academy 		Ğ°ĞºĞ°Ğ´ĞµĞ¼Ğ¸Ñ  akademiia  âœ“

ac- <> ÑĞ¾- <> zu- !!
+++++++++++++++++
accede 		ÑĞ¾Ğ³Ğ»Ğ°ÑˆĞ°Ñ‚ÑŒÑÑ  soglashatsia   (zustimmen) ?
accord 		ÑĞ¾Ğ³Ğ»Ğ°ÑĞ¸Ğµ ÑĞ¾Ğ¾Ñ‚Ğ²ĞµÑ‚ÑÑ‚Ğ²Ğ¸Ğµ  soglasie sootvetstvie 
accordance 		ÑĞ¾Ğ³Ğ»Ğ°ÑĞ¸Ğµ ÑĞ¾Ğ¾Ñ‚Ğ²ĞµÑ‚ÑÑ‚Ğ²Ğ¸Ğµ  soglasie sootvetstvie 
accompany 		ÑĞ¾Ğ¿Ñ€Ğ¾Ğ²Ğ¾Ğ¶Ğ´Ğ°Ñ‚ÑŒ  soprovoÎ¶edat 

accent 		Ğ°ĞºÑ†ĞµĞ½Ñ‚  akssent  âœ“
accept 		Ğ¿Ñ€Ğ¸Ğ½Ğ¸Ğ¼Ğ°Ñ‚ÑŒ  prinimat  << prendre? âœ“ 
access 		Ğ°Ñ‚Ğ°ĞºĞ°  ataka ~âœ“ 
accident 		Ğ½ĞµÑÑ‡Ğ°ÑÑ‚Ğ½Ñ‹Ğ¹ ÑĞ»ÑƒÑ‡Ğ°Ğ¹  neschastnÄ—iy sluchay  
accommodation 		Ğ°ĞºĞºĞ¾Ñ€Ğ´  akkord ~âœ“?
accomplishment 		Ğ°ĞºÑ‚  akt âœ“ !! <<
accordion 		Ğ³Ğ°Ñ€Ğ¼Ğ¾Ğ½ÑŒ  garmon  âœ“

account 		ÑÑ‡Ğ¸Ñ‚Ğ°Ñ‚ÑŒ  schitat <> Giro? << 
accounting 		Ğ±ÑƒÑ…Ğ³Ğ°Ğ»Ñ‚ĞµÑ€Ğ¸Ñ  buxghalteriia âœ“âœ“ ++ DE

accrue 		Ñ€Ğ°ÑÑ‚Ğ¸  rasti   (anfallen,auflaufen) ?/
accumulator 		Ğ°ĞºĞºÑƒĞ¼ÑƒĞ»ÑÑ‚Ğ¾Ñ€  akkumuliator  âœ“
accurate 		Ğ°ĞºĞºÑƒÑ€Ğ°Ñ‚Ğ½Ñ‹Ğ¹  akkuratnÄ—iy âœ“

ache 		Ğ±Ğ¾Ğ»ÑŒ  bol << <> pain?

achieve 		Ğ´ĞµĞ»Ğ°Ñ‚ÑŒ ÑĞ´ĞµĞ»Ğ°Ñ‚ÑŒ  delat sdelat ?
achievement 		Ğ°ĞºÑ‚  akt âœ“

achromatic 		Ğ±ĞµÑÑ†Ğ²ĞµÑ‚Ğ½Ñ‹Ğ¹  bes-svetnÄ—iy des-schwarÅ›+++ <<

ackâ€ack 		Ğ·ĞµĞ½Ğ¸Ñ‚Ğ½Ğ°Ñ Ğ°Ñ€Ñ‚Ğ¸Ğ»Ğ»ĞµÑ€Ğ¸Ñ  Å›enitnaia artilleriia wtf?
acquire 		Ğ¿Ğ¾ĞºÑƒĞ¿Ğ°Ñ‚ÑŒ ĞºÑƒĞ¿Ğ¸Ñ‚ÑŒ  pokupat kupit << capture âœ“ +
acquisitive 		Ğ°Ğ»Ñ‡Ğ½Ñ‹Ğ¹  alchnÄ—iy  (habgierig) ?
acrobat 		Ğ°ĞºÑ€Ğ¾Ğ±Ğ°Ñ‚  akrobat  âœ“
acrobatic 		Ğ°ĞºÑ€Ğ¾Ğ±Ğ°Ñ‚Ğ¸Ñ‡ĞµÑĞºĞ¸Ğ¹  akrobaticheskiy  âœ“

across 		Ğ¿Ğ¾Ğ¿ĞµÑ€Ñ‘Ğº  poperÑ‘k <> para!! << âœ“
across from 		Ğ¿Ñ€Ğ¾Ñ‚Ğ¸Ğ²  protiv  << ~âœ“

act 		Ğ°ĞºÑ‚  akt  âœ“
action 		Ğ°ĞºÑ‚  akt  âœ“
active 		Ğ°ĞºÑ‚Ğ¸Ğ²Ğ½Ñ‹Ğ¹  aktivnÄ—iy âœ“
activity 		Ğ°ĞºÑ‚Ğ¸Ğ²Ğ½Ğ¾ÑÑ‚ÑŒ  aktivnost  âœ“   aktive-ness ++
actor 		Ğ°ĞºÑ‚Ñ‘Ñ€  aktÑ‘r  âœ“
actress 		Ğ°ĞºÑ‚Ñ€Ğ¸ÑĞ°  aktrisa  âœ“
act of grace 		Ğ°Ğ¼Ğ½Ğ¸ÑÑ‚Ğ¸Ñ  amnistiia 
addled 		Ğ³Ğ»ÑƒĞ¼Ñ‹Ğ¹  glumÄ—iy  (verdorben)?
address 		Ğ°Ğ´Ñ€ĞµÑĞ¾Ğ²Ğ°Ñ‚ÑŒ  adresovat  âœ“
adjutant 		Ğ°Ğ´ÑŠÑÑ‚Ğ°Ğ½Ñ‚  adhutant  âœ“
administer 		Ğ°Ğ´Ğ¼Ğ¸Ğ½Ğ¸ÑÑ‚Ñ€Ğ¸Ñ€Ğ¾Ğ²Ğ°Ñ‚ÑŒ  administrirovat  âœ“
administration 		Ğ°Ğ´Ğ¼Ğ¸Ğ½Ğ¸ÑÑ‚Ñ€Ğ°Ñ†Ğ¸Ñ  administrassiia  âœ“
administrative 		Ğ°Ğ´Ğ¼Ğ¸Ğ½Ğ¸ÑÑ‚Ñ€Ğ°Ñ‚Ğ¸Ğ²Ğ½Ñ‹Ğ¹  administrativnÄ—iy  âœ“
admiral 		Ğ°Ğ´Ğ¼Ğ¸Ñ€Ğ°Ğ»  admiral  âœ“
admiralship 		Ğ°Ğ´Ğ¼Ğ¸Ñ€Ğ°Ğ»ÑŒÑĞºĞ¸Ğ¹  admiralskiy  âœ“
admire 		Ğ²Ğ¾ÑÑ…Ğ¸Ñ‰Ğ°Ñ‚ÑŒÑÑ  vosxischatsia 
adore 		Ğ±Ğ¾Ğ³Ğ¾Ñ‚Ğ²Ğ¾Ñ€Ğ¸Ñ‚ÑŒ  bogotvorit 
advantageous 		Ğ¿Ğ¾Ğ»ĞµĞ·Ğ½Ñ‹Ğ¹  poleÅ›nÄ—iy 
adventure 		Ğ°Ğ²Ğ°Ğ½Ñ‚ÑÑ€Ğ°  avantura  âœ“
adventurous 		Ğ°Ğ²Ğ°Ğ½Ñ‚ÑÑ€Ğ½Ñ‹Ğ¹  avanturnÄ—iy  âœ“

advertisement 		Ğ°Ğ½Ğ¾Ğ½Ñ  anons  ?
ad 		Ğ°Ğ½Ğ¾Ğ½Ñ  anons 

advice 		ÑĞ¾Ğ²ĞµÑ‚  sovet <<< Soviet = Rat!!

advocate 		Ğ°Ğ´Ğ²Ğ¾ĞºĞ°Ñ‚  advokat  âœ“
aerial 		Ğ°Ğ½Ñ‚ĞµĞ½Ğ½Ğ°  antenna 	~âœ“!
aerodrome 		Ğ°ÑÑ€Ğ¾Ğ´Ñ€Ğ¾Ğ¼  aairodrom  âœ“
aerolite 		Ğ°ÑÑ€Ğ¾Ğ»Ğ¸Ñ‚  aairolit  âœ“
aeronautical 		Ğ°Ğ²Ğ¸Ğ°Ñ†Ğ¸Ğ¾Ğ½Ğ½Ñ‹Ğ¹  aviassionnÄ—iy  âœ“ < aviation++
aeronautics 		Ğ°Ğ²Ğ¸Ğ°Ñ†Ğ¸Ñ  aviassiia  âœ“ < aviation++
aeroplane 		Ğ°ÑÑ€Ğ¾Ğ¿Ğ»Ğ°Ğ½ ÑĞ°Ğ¼Ğ¾Ğ»Ñ‘Ñ‚  aairoplanâœ“  samolÑ‘t ?

affair 		Ğ´ĞµĞ»Ğ¾  delo ?

affluent 		Ğ±Ğ¾Ğ³Ğ°Ñ‚Ñ‹Ğ¹  bogatÄ—iy  << Bogota?
affluence 		Ğ±Ğ¾Ğ³Ğ°Ñ‚ÑÑ‚Ğ²Ğ¾  bogatstvo 

afresh 		Ğ¾Ğ¿ÑÑ‚ÑŒ  opiat :) LOL!! <<< ~afresh
again 		Ğ¾Ğ¿ÑÑ‚ÑŒ  opiat <<< </>opposite

against 		Ğ¿Ñ€Ğ¾Ñ‚Ğ¸Ğ²  protiv  ~ <<

after 		Ğ·Ğ°  (a)Å›a  <<

afternoon 		Ğ¿Ğ¾Ğ¿Ğ¾Ğ»ÑƒĞ´Ğ½Ğ¸  popoludni ??

age 		Ğ²Ğ¾Ğ·Ñ€Ğ°ÑÑ‚  voÅ›rast ??? <<<

agency 		Ğ°Ğ³ĞµĞ½Ñ‚ÑÑ‚Ğ²Ğ¾  agentstvo âœ“
agent 		Ğ°Ğ³ĞµĞ½Ñ‚  agent  âœ“
aggression 		Ğ°Ğ³Ñ€ĞµÑÑĞ¸Ñ  agressiia  âœ“
aggressive 		Ğ°Ğ³Ñ€ĞµÑÑĞ¸Ğ²Ğ½Ñ‹Ğ¹  agressivnÄ—iy  âœ“
aggressor 		Ğ°Ğ³Ñ€ĞµÑÑĞ¾Ñ€  agressor  âœ“
aggro 		Ğ°Ğ³Ñ€ĞµÑÑĞ¸Ñ  agressiia âœ“
agrarian 		Ğ°Ğ³Ñ€Ğ°Ñ€Ğ½Ñ‹Ğ¹  agrarnÄ—iy  âœ“

agree 		ÑĞ¾Ğ³Ğ»Ğ°ÑˆĞ°Ñ‚ÑŒÑÑ  soglashatsia  << zu-stimmen ~~âœ“
agreement 		ÑĞ¾Ğ³Ğ»Ğ°ÑĞ¸Ğµ ÑĞ¾Ğ¾Ñ‚Ğ²ĞµÑ‚ÑÑ‚Ğ²Ğ¸Ğµ  soglasie sootvetstvie 

agricultural 		Ğ°Ğ³Ñ€Ğ°Ñ€Ğ½Ñ‹Ğ¹  agrarnÄ—iy âœ“
agriculture 		Ğ°Ğ³Ñ€Ğ¾Ğ½Ğ¾Ğ¼Ğ¸Ñ  agronomiia âœ“
agriculturist 		Ğ°Ğ³Ñ€Ğ¾Ğ½Ğ¾Ğ¼  agronom  âœ“
agronomics 		Ğ°Ğ³Ñ€Ğ¾Ğ½Ğ¾Ğ¼Ğ¸Ñ  agronomiia  âœ“

agricultural labourer 		Ğ±Ğ°Ñ‚Ñ€Ğ°Ğº  batrak <<
agricultural worker 		Ğ±Ğ°Ñ‚Ñ€Ğ°Ğº  batrak 


aideâ€deâ€camp 		Ğ°Ğ´ÑŠÑÑ‚Ğ°Ğ½Ñ‚  adhutant Æ’?

ailment 		Ğ±Ğ¾Ğ»ĞµĞ·Ğ½ÑŒ  boleÅ›n  << balsam
ailing 		Ğ±Ğ¾Ğ»ĞµĞ·Ğ½ĞµĞ½Ğ½Ñ‹Ğ¹  boleÅ›nennÄ—iy 

aim 		Ñ†ĞµĞ»ÑŒ  ssel   <<> bomb shells! 
aimless 		Ğ±ĞµÑÑ†ĞµĞ»ÑŒĞ½Ñ‹Ğ¹  bes-ssel-nÄ—iy 

airâ€balloon 		Ğ°ÑÑ€Ğ¾ÑÑ‚Ğ°Ñ‚  aairostat ~âœ“

air 		Ğ²Ğ¾Ğ·Ğ´ÑƒÑ…  voÅ›dux  <<<<<<<<<  <> vends-duct bos:ox!!
airless 		Ğ±ĞµĞ·Ğ²ĞµÑ‚Ñ€ĞµĞ½Ğ½Ñ‹Ğ¹  Ğ±ĞµÅ›--vetrennÄ—iy  des-ventre-ny  <> vetrenÃ¤r??

aircraft 		Ğ°ÑÑ€Ğ¾Ğ¿Ğ»Ğ°Ğ½ ÑĞ°Ğ¼Ğ¾Ğ»Ñ‘Ñ‚  aairoplanâœ“ samolÑ‘t ? <<
airplane 		Ğ°ÑÑ€Ğ¾Ğ¿Ğ»Ğ°Ğ½ ÑĞ°Ğ¼Ğ¾Ğ»Ñ‘Ñ‚  aairoplan samolÑ‘t 
airdrome 		Ğ°ÑÑ€Ğ¾Ğ´Ñ€Ğ¾Ğ¼  aairodrom  âœ“
airfield 		Ğ°ÑÑ€Ğ¾Ğ´Ñ€Ğ¾Ğ¼  aairodrom âœ“
airline 		Ğ°Ğ²Ğ¸Ğ°Ğ»Ğ¸Ğ½Ğ¸Ñ  avialiniia  âœ“
airmail 		Ğ°Ğ²Ğ¸Ğ°Ğ¿Ğ¾Ñ‡Ñ‚Ğ°  aviapochta âœ“ <3 ++
airport 		Ğ°ÑÑ€Ğ¾Ğ´Ñ€Ğ¾Ğ¼  aairodrom  âœ“
airway 		Ğ°Ğ²Ğ¸Ğ°Ğ»Ğ¸Ğ½Ğ¸Ñ  avialiniia âœ“
air force 		Ğ°Ğ²Ğ¸Ğ°Ñ†Ğ¸Ñ  aviassiia âœ“ aviation

alarm 		Ğ±ÑƒĞ´Ğ¸Ğ»ÑŒĞ½Ğ¸Ğº  budilnik << ?
alarmclock 		Ğ±ÑƒĞ´Ğ¸Ğ»ÑŒĞ½Ğ¸Ğº  budilnik   <> bell?

alas 		Ğº ÑĞ¾Ğ¶Ğ°Ğ»ĞµĞ½Ğ¸Ñ  k soÎ¶ealeniÑ ?
albino 		Ğ°Ğ»ÑŒĞ±Ğ¸Ğ½Ğ¾Ñ  albinos  âœ“
album 		Ğ°Ğ»ÑŒĞ±Ğ¾Ğ¼  albom  âœ“
alcohol 		Ğ°Ğ»ĞºĞ¾Ğ³Ğ¾Ğ»ÑŒ  alkogol  âœ“
alcoholic 		Ğ°Ğ»ĞºĞ¾Ğ³Ğ¾Ğ»Ğ¸Ñ‡ĞµÑĞºĞ¸Ğ¹ Ğ°Ğ»ĞºĞ¾Ğ³Ğ¾Ğ»ÑŒĞ½Ñ‹Ğ¹  alkogolicheskiy alkogolnÄ—iy âœ“
alcoholism 		Ğ°Ğ»ĞºĞ¾Ğ³Ğ¾Ğ»Ğ¸Ğ·Ğ¼  alkogoliÅ›m  âœ“
algebra 		Ğ°Ğ»Ğ³ĞµĞ±Ñ€Ğ°  algebra  âœ“
algebraic 		Ğ°Ğ»Ğ³ĞµĞ±Ñ€Ğ°Ğ¸Ñ‡ĞµÑĞºĞ¸Ğ¹  algebraicheskiy âœ“

alien 		Ğ¸Ğ½Ğ¾ÑÑ‚Ñ€Ğ°Ğ½Ğ½Ñ‹Ğ¹  inostrannÄ—iy   1) Â¬nosta 2) in.austral ?? <<

altitude 		Ğ²Ñ‹ÑĞ¾Ñ‚Ğ°  vÄ—isota << â„¢
<!>
all 		Ğ²ÑÑ‘  vsÑ‘  <<<<<<<<
altogether 		Ğ²ÑÑ‘  vsÑ‘ 
always 		Ğ²ÑĞµĞ³Ğ´Ğ°  vsegda 
all the 		Ğ²ÑĞµ ĞºĞ°Ğ¶Ğ´Ñ‹Ğ¹  vse kaÎ¶edÄ—iy 
all of a sudden 		Ğ²Ğ´Ñ€ÑƒĞ³  vdrug 

all over again 		Ğ¾Ğ¿ÑÑ‚ÑŒ  opiat ~ over << ^^!

allow 		Ğ¿ÑƒÑĞºĞ°Ñ‚ÑŒ Ğ¿ÑƒÑÑ‚Ğ¸Ñ‚ÑŒ  puskat pustit <> potent ~~âœ“-
almost 		Ğ¿Ğ¾Ñ‡Ñ‚Ğ¸  pochti  fast++ <<<
alms 		Ğ¼Ğ¸Ğ»Ğ¾ÑÑ‚Ñ‹Ğ½Ñ  (a)milostÄ—inia  << 

alone 		Ğ¾Ğ´Ğ¸Ğ½  odin  << 1 âœ“

along 		Ğ¼Ğ¸Ğ¼Ğ¾  mimo << among mit simil EG!! <<< +++
among 		Ğ¼ĞµĞ¶Ğ´Ñƒ  meÎ¶edu <<<> ~~mit (âœ“) 

also 		Ñ‚Ğ°ĞºĞ¶Ğµ Ñ‚Ğ¾Ğ¶Ğµ  takÎ¶ee toÎ¶ee  <<<
already 		ÑƒĞ¶Ğµ  uÎ¶ee  <<> yet ~~âœ“ -
although 		Ñ…Ğ¾Ñ‚Ñ  xotia <<

alphabet 		Ğ°Ğ·Ğ±ÑƒĞºĞ° Ğ°Ğ»Ñ„Ğ°Ğ²Ğ¸Ñ‚  acbuca alphavit âœ“
alphabetical 		Ğ°Ğ·Ğ±ÑƒÑ‡Ğ½Ñ‹Ğ¹  aÅ›buchnÄ—iy âœ“
altar 		Ğ°Ğ»Ñ‚Ğ°Ñ€ÑŒ  altar  âœ“

aluminium 		Ğ°Ğ»ÑĞ¼Ğ¸Ğ½Ğ¸Ğ¹  aluminiy  âœ“
aluminum 		Ğ°Ğ»ÑĞ¼Ğ¸Ğ½Ğ¸Ğ¹  aluminiy  âœ“
ambition 		Ğ°Ğ¼Ğ±Ğ¸Ñ†Ğ¸Ñ  ambissiia  âœ“
ammonia 		Ğ°Ğ¼Ğ¼Ğ¸Ğ°Ğº  ammiak  âœ“
amnesty 		Ğ¾Ğ±ÑŠÑĞ²Ğ¸Ñ‚ÑŒ Ğ°Ğ¼Ğ½Ğ¸ÑÑ‚Ğ¸Ñ  obhiavit amnistiÑ âœ“
amphibian 		Ğ°Ğ¼Ñ„Ğ¸Ğ±Ğ¸Ñ  ampthibiia  âœ“ <<  Ñ„ Ptheben MIX!
amphibious vehicle 		Ğ°Ğ¼Ñ„Ğ¸Ğ±Ğ¸Ñ  amphibiia  âœ“
amputate 		Ğ°Ğ¼Ğ¿ÑƒÑ‚Ğ¸Ñ€Ğ¾Ğ²Ğ°Ñ‚ÑŒ  amputirovat  âœ“
amputation 		Ğ°Ğ¼Ğ¿ÑƒÑ‚Ğ°Ñ†Ğ¸Ñ  amputassiia  âœ“
analogous 		Ğ°Ğ½Ğ°Ğ»Ğ¾Ğ³Ğ¸Ñ‡Ğ½Ñ‹Ğ¹  analogichnÄ—iy 
analogy 		Ğ°Ğ½Ğ°Ğ»Ğ¾Ğ³Ğ¸Ñ  analogiia  âœ“
analyse 		Ğ°Ğ½Ğ°Ğ»Ğ¸Ğ·Ğ¸Ñ€Ğ¾Ğ²Ğ°Ñ‚ÑŒ  analiÅ›irovat  âœ“
analysis 		Ğ°Ğ½Ğ°Ğ»Ğ¸Ğ·  analiÅ›  âœ“
analytic 		Ğ°Ğ½Ğ°Ğ»Ğ¸Ñ‚Ğ¸Ñ‡ĞµÑĞºĞ¸Ğ¹  analiticheskiy âœ“
analytical 		Ğ°Ğ½Ğ°Ğ»Ğ¸Ñ‚Ğ¸Ñ‡ĞµÑĞºĞ¸Ğ¹  analiticheskiy âœ“ 
anarchic 		Ğ°Ğ½Ğ°Ñ€Ñ…Ğ¸Ñ‡ĞµÑĞºĞ¸Ğ¹  anarxicheskiy âœ“
anarchical 		Ğ°Ğ½Ğ°Ñ€Ñ…Ğ¸Ñ‡ĞµÑĞºĞ¸Ğ¹  anarxicheskiy âœ“ 
anarchism 		Ğ°Ğ½Ğ°Ñ€Ñ…Ğ¸Ğ·Ğ¼  anarxiÅ›m  âœ“
anarchist 		Ğ°Ğ½Ğ°Ñ€Ñ…Ğ¸Ñ‡ĞµÑĞºĞ¸Ğ¹  anarxicheskiy  âœ“
anarchy 		Ğ°Ğ½Ğ°Ñ€Ñ…Ğ¸Ñ Ğ±ĞµĞ·Ğ½Ğ°Ñ‡Ğ°Ğ»Ğ¸Ğµ  anarxiiaâœ“ Ğ±ĞµÅ›-nachalie <<
anatomical 		Ğ°Ğ½Ğ°Ñ‚Ğ¾Ğ¼Ğ¸Ñ‡ĞµÑĞºĞ¸Ğ¹  anatomicheskiy âœ“
anatomist 		Ğ°Ğ½Ğ°Ñ‚Ğ¾Ğ¼  anatom  âœ“
anatomy 		Ğ°Ğ½Ğ°Ñ‚Ğ¾Ğ¼Ğ¸Ñ  anatomiia  âœ“
anchovy 		Ğ°Ğ½Ñ‡Ğ¾ÑƒÑ  anchous  âœ“     -ÑƒÑ -vys! -ous -us

and 		Ğ° Ğ¸  a i  âœ“ <<

anecdote 		Ğ°Ğ½ĞµĞºĞ´Ğ¾Ñ‚  anekdot  âœ“

anew 		Ğ¾Ğ¿ÑÑ‚ÑŒ  opiat  ^^

any 		ĞºÑ‚Ğ¾â€Ñ‚Ğ¾  ktoâ€to <> EG !!! <<<< ++?????????????????
anybody 		ĞºÑ‚Ğ¾â€Ñ‚Ğ¾  ktoâ€to 
another 		Ğ´Ñ€ÑƒĞ³Ğ¾Ğ¹  drugoy  <> EG?

anise 		Ğ°Ğ½Ğ¸Ñ  anis  âœ“
annexation 		Ğ°Ğ½Ğ½ĞµĞºÑĞ¸Ñ  anneksiia  âœ“
anonymous 		Ğ±ĞµĞ·Ñ‹Ğ¼ÑĞ½Ğ½Ñ‹Ğ¹  beÅ›-Ä—imiannÄ—iy  <<< +?
answer 		Ğ¾Ñ‚Ğ²ĞµÑ‡Ğ°Ñ‚ÑŒ Ğ¾Ñ‚Ğ²ĞµÑ‚Ğ¸Ñ‚ÑŒ  otvechat otvetit 
antelope 		Ğ°Ğ½Ñ‚Ğ¸Ğ»Ğ¾Ğ¿Ğ°  antilopa  âœ“
antenna 		Ğ°Ğ½Ñ‚ĞµĞ½Ğ½Ğ°  antenna  âœ“
anthracite 		Ğ°Ğ½Ñ‚Ñ€Ğ°Ñ†Ğ¸Ñ‚  antrassit  âœ“
antiâ€aircraft guns 		Ğ·ĞµĞ½Ğ¸Ñ‚Ğ½Ğ°Ñ Ğ°Ñ€Ñ‚Ğ¸Ğ»Ğ»ĞµÑ€Ğ¸Ñ  Å›enit!naia artilleriia  âœ“   Ğ·ĞµĞ½Ğ¸Ñ‚ Zenit!
apartment 		ĞºĞ²Ğ°Ñ€Ñ‚Ğ¸Ñ€Ğ°  kvartira  âœ“
apathetic 		Ğ°Ğ¿Ğ°Ñ‚Ğ¸Ñ‡Ğ½Ñ‹Ğ¹  apatichnÄ—iy  âœ“
apathy 		Ğ°Ğ¿Ğ°Ñ‚Ğ¸Ñ  apatiia  âœ“
ape 		Ğ¾Ğ±ĞµĞ·ÑŒÑĞ½Ğ°  oĞ±ĞµÅ›-iana @ Abbessinia!!! <<< ++ Obo vs Ono ! 
apostle 		Ğ°Ğ¿Ğ¾ÑÑ‚Ğ¾Ğ»  apostol  âœ“
apparatus 		Ğ°Ğ¿Ğ¿Ğ°Ñ€Ğ°Ñ‚  apparat  âœ“
appeal 		Ğ°Ğ¿ĞµĞ»Ğ»Ğ¸Ñ€Ğ¾Ğ²Ğ°Ñ‚ÑŒ  apellirovat âœ“ !!!
appeal to 		Ğ°Ğ¿ĞµĞ»Ğ»Ğ¸Ñ€Ğ¾Ğ²Ğ°Ñ‚ÑŒ Ğº  apellirovatâœ“ k 
appellation 		Ğ¸Ğ¼Ñ  imia ?? <<
appetite 		Ğ°Ğ¿Ğ¿ĞµÑ‚Ğ¸Ñ‚  appetit  âœ“

appleâ€tree 		ÑĞ±Ğ»Ğ¾Ğ½Ñ  iablonia âœ“ !!! apple<>diabol!!! <<<
apple 		ÑĞ±Ğ»Ğ¾ĞºĞ¾  iabloko   âœ“ !!! apple<>diabol!!! <<<

apprehension 		Ğ°Ñ€ĞµÑÑ‚  arest âœ“
approximately 		Ğ¿Ñ€Ğ¸Ğ±Ğ»Ğ¸Ğ·Ğ¸Ñ‚ĞµĞ»ÑŒĞ½Ğ¾ Ğ¿Ñ€Ğ¸Ğ¼ĞµÑ€Ğ½Ğ¾  pribliÅ›itelno??? primerno ~~âœ“?
apricot 		Ğ°Ğ±Ñ€Ğ¸ĞºĞ¾Ñ  abrikos  âœ“
aquarium 		Ğ°ĞºĞ²Ğ°Ñ€Ğ¸ÑƒĞ¼  akvarium  âœ“
arbiter 		Ğ°Ñ€Ğ±Ğ¸Ñ‚Ñ€  arbitr  âœ“
arbitration 		Ğ°Ñ€Ğ±Ğ¸Ñ‚Ñ€Ğ°Ğ¶  arbitraÎ¶e  âœ“
arbitrator 		Ğ°Ñ€Ğ±Ğ¸Ñ‚Ñ€  arbitr  âœ“
arc 		Ğ°Ñ€ĞºĞ°  arka  âœ“
arch 		Ğ°Ñ€ĞºĞ°  arka  âœ“
archaeological 		Ğ°Ñ€Ñ…ĞµĞ¾Ğ»Ğ¾Ğ³Ğ¸Ñ‡ĞµÑĞºĞ¸Ğ¹  arxeologicheskiy âœ“
archaeologist 		Ğ°Ñ€Ñ…ĞµĞ¾Ğ»Ğ¾Ğ³  arxeolog  âœ“
archaeology 		Ğ°Ñ€Ñ…ĞµĞ¾Ğ»Ğ¾Ğ³Ğ¸Ñ  arxeologiia  âœ“
archbishop 		Ğ°Ñ€Ñ…Ğ¸ĞµĞ¿Ğ¸ÑĞºĞ¾Ğ¿  arxiepiskop  âœ“
archipelago 		Ğ°Ñ€Ñ…Ğ¸Ğ¿ĞµĞ»Ğ°Ğ³  arxipelag  âœ“
architect 		Ğ°Ñ€Ñ…Ğ¸Ñ‚ĞµĞºÑ‚Ğ¾Ñ€  arxitektor  âœ“
architectonic 		Ğ°Ñ€Ñ…Ğ¸Ñ‚ĞµĞºÑ‚ÑƒÑ€Ğ½Ñ‹Ğ¹  arxitekturnÄ—iy  âœ“
architectural 		Ğ°Ñ€Ñ…Ğ¸Ñ‚ĞµĞºÑ‚ÑƒÑ€Ğ½Ñ‹Ğ¹  arxitekturnÄ—iy  âœ“
architecture 		Ğ°Ñ€Ñ…Ğ¸Ñ‚ĞµĞºÑ‚ÑƒÑ€Ğ°  arxitektura  âœ“
archive 		Ğ°Ñ€Ñ…Ğ¸Ğ²  arxiv  âœ“
archives 		Ğ°Ñ€Ñ…Ğ¸Ğ²  arxiv  âœ“
archivist 		Ğ°Ñ€Ñ…Ğ¸Ğ²Ğ°Ñ€Ğ¸ÑƒÑ  arxivarius  âœ“
arena 		Ğ°Ñ€ĞµĞ½Ğ°  arena  âœ“
argument 		Ğ°Ñ€Ğ³ÑƒĞ¼ĞµĞ½Ñ‚  argument  âœ“
aristocracy 		Ğ°Ñ€Ğ¸ÑÑ‚Ğ¾ĞºÑ€Ğ°Ñ‚Ğ¸Ñ  aristokratiia  âœ“
aristocrat 		Ğ°Ñ€Ğ¸ÑÑ‚Ğ¾ĞºÑ€Ğ°Ñ‚  aristokrat  âœ“
aristocratic 		Ğ°Ñ€Ğ¸ÑÑ‚Ğ¾ĞºÑ€Ğ°Ñ‚Ğ¸Ñ‡ĞµÑĞºĞ¸Ğ¹ Ğ°Ñ€Ğ¸ÑÑ‚Ğ¾ĞºÑ€Ğ°Ñ‚Ğ¸Ñ‡Ğ½Ñ‹Ğ¹  aristokraticheskiy aristokratichnÄ—iy 
arithmetic 		Ğ°Ñ€Ğ¸Ñ„Ğ¼ĞµÑ‚Ğ¸ĞºĞ°  arithmetika  âœ“   <> rift

arm 		Ñ€ÑƒĞºĞ°  ruka  <<<<<<<<<<<<<<<< !?
army 		Ğ°Ñ€Ğ¼Ğ¸Ñ Ğ²Ğ¾ĞµĞ½Ğ½Ñ‹Ğµ Ğ²Ğ¾Ğ¹ÑĞºĞ¾  armiiaâœ“ voennÄ—ie voysko ?? __ <<

armature 		Ğ°Ñ€Ğ¼Ğ°Ñ‚ÑƒÑ€  armatur  âœ“
armchair 		ĞºÑ€ĞµÑĞ»Ğ¾  kreslo ?
armoury 		Ğ°Ñ€ÑĞµĞ½Ğ°Ğ»  arsenal  âœ“
aroma 		Ğ°Ñ€Ğ¾Ğ¼Ğ°Ñ‚  aromat  âœ“
aromatic 		Ğ°Ñ€Ğ¾Ğ¼Ğ°Ñ‚Ğ¸Ñ‡ĞµÑĞºĞ¸Ğ¹ Ğ°Ñ€Ğ¾Ğ¼Ğ°Ñ‚Ğ¸Ñ‡Ğ½Ñ‹Ğ¹  aromaticheskiy aromatichnÄ—iy âœ“
arouse 		Ñ€Ğ°Ğ·Ğ±ÑƒĞ´Ğ¸Ñ‚ÑŒ  raÅ›budit  raiseâœ“budit??
arrest 		Ğ°Ñ€ĞµÑÑ‚  arest  âœ“
arrested person 		Ğ°Ñ€ĞµÑÑ‚Ğ°Ğ½Ñ‚  arestant âœ“

arrival 		Ğ¿Ñ€Ğ¸ĞµĞ·Ğ´ Ğ¿Ñ€Ğ¸Ñ…Ğ¾Ğ´  prieÅ›d prixod <<<<> proxim?
arrive 		Ğ¿Ñ€Ğ¸Ğ±Ñ‹Ñ‚ÑŒ Ğ¿Ñ€Ğ¸Ğ±Ñ‹Ğ²Ğ°Ñ‚ÑŒ  pribÄ—it pribÄ—ivat 

arsenal 		Ğ°Ñ€ÑĞµĞ½Ğ°Ğ»  arsenal  âœ“
arteriosclerosis 		Ğ°Ñ€Ñ‚ĞµÑ€Ğ¸Ğ¾ĞºĞ»ĞµÑ€Ğ¾Ğ·  arteriokleroÅ›  âœ“
artery 		Ğ°Ñ€Ñ‚ĞµÑ€Ğ¸Ñ  arteriia  âœ“
article 		Ğ°Ñ€Ñ‚Ğ¸ĞºĞ»ÑŒ  artikl  âœ“
artillery 		Ğ°Ñ€Ñ‚Ğ¸Ğ»Ğ»ĞµÑ€Ğ¸Ñ  artilleriia  âœ“
artilleryman 		Ğ°Ñ€Ñ‚Ğ¸Ğ»Ğ»ĞµÑ€Ğ¸ÑÑ‚  artillerist  âœ“
artist 		Ğ°Ñ€Ñ‚Ğ¸ÑÑ‚  artist  âœ“
artistic 		Ğ°Ñ€Ñ‚Ğ¸ÑÑ‚Ğ¸Ñ‡ĞµÑĞºĞ¸Ğ¹  artisticheskiy âœ“

<<<<<<<<<<<<<<<<<<<<<<<<<<<<<<<<<<<<<<<<<<<
as 		ĞºĞ°Ğº  kak  âœ“ <<
as if 		Ğ±ÑƒĞ´Ñ‚Ğ¾  budto 
as though 		Ğ±ÑƒĞ´Ñ‚Ğ¾  budto 
at 		Ğ² Ğº Ğ½Ğ°  v k na 


ascend 		Ğ¿Ğ¾Ğ´Ğ½Ğ¸Ğ¼Ğ°Ñ‚ÑŒÑÑ Ğ¿Ğ¾Ğ´Ğ½ÑÑ‚ÑŒÑÑ  podnimatsia podniatsia <<< pod + airpod !!! <<<
ask 		ÑĞ¿Ñ€Ğ°ÑˆĞ¸Ğ²Ğ°Ñ‚ÑŒ ÑĞ¿Ñ€Ğ¾ÑĞ¸Ñ‚ÑŒ  sprashivat sprosit  <> sprechen!! <<< +++

asbestos 		Ğ°ÑĞ±ĞµÑÑ‚  asbest  âœ“
ascetic 		Ğ°ÑĞºĞµÑ‚Ğ¸Ñ‡ĞµÑĞºĞ¸Ğ¹  asketicheskiy âœ“
asphalt 		Ğ°ÑÑ„Ğ°Ğ»ÑŒÑ‚Ğ¸Ñ€Ğ¾Ğ²Ğ°Ñ‚ÑŒ  asphaltirovat Ñ„ âœ“
assailant 		Ğ°Ğ³Ñ€ĞµÑÑĞ¾Ñ€  agressor âœ“
assault 		Ğ°Ñ‚Ğ°ĞºĞ¾Ğ²Ğ°Ñ‚ÑŒ  atakovat âœ“  attack!!
assembly 		Ğ°ÑÑĞ°Ğ¼Ğ±Ğ»ĞµÑ  assambleia  âœ“
assimilation 		Ğ°ÑÑĞ¸Ğ¼Ğ¸Ğ»ÑÑ†Ğ¸Ñ  assimiliassiia  âœ“
assistant 		Ğ°Ğ´ÑŠÑĞ½ĞºÑ‚  adhunkt <<
association 		Ğ°ÑÑĞ¾Ñ†Ğ¸Ğ°Ñ†Ğ¸Ñ  assossiassiia  âœ“
aster 		Ğ°ÑÑ‚Ñ€Ğ°  astra  âœ“
asthma 		Ğ°ÑÑ‚Ğ¼Ğ°  astma  âœ“
asthmatic 		Ğ°ÑÑ‚Ğ¼Ğ°Ñ‚Ğ¸Ñ‡ĞµÑĞºĞ¸Ğ¹  astmaticheskiy âœ“
astrology 		Ğ°ÑÑ‚Ñ€Ğ¾Ğ»Ğ¾Ğ³Ğ¸Ñ  astrologiia  âœ“

atheism 		Ğ°Ñ‚ĞµĞ¸Ğ·Ğ¼  ateiÅ›m  âœ“
atheist 		Ğ°Ñ‚ĞµĞ¸ÑÑ‚ Ğ±ĞµĞ·Ğ±Ğ¾Ğ¶Ğ½Ğ¸Ğº  ateist / Ğ±ĞµÅ›-boÎ¶enik?
athlete 		Ğ°Ñ‚Ğ»ĞµÑ‚  atlet  âœ“
athletic 		Ğ°Ñ‚Ğ»ĞµÑ‚Ğ¸Ñ‡ĞµÑĞºĞ¸Ğ¹  atleticheskiy âœ“
athletics 		Ğ°Ñ‚Ğ»ĞµÑ‚Ğ¸ĞºĞ°  atletika  âœ“
atlas 		Ğ°Ñ‚Ğ»Ğ°Ñ  atlas  âœ“
atmosphere 		Ğ°Ñ‚Ğ¼Ğ¾ÑÑ„ĞµÑ€Ğ°  atmosphera atmosthera!!  âœ“   out-most-terra atmo-sphere !! << ++-++
atmospheric 		Ğ°Ñ‚Ğ¼Ğ¾ÑÑ„ĞµÑ€Ğ¸Ñ‡ĞµÑĞºĞ¸Ğ¹ Ğ°Ñ‚Ğ¼Ğ¾ÑÑ„ĞµÑ€Ğ½Ñ‹Ğ¹  atmosthericheskiy atmosthernÄ—iy âœ“
atom 		Ğ°Ñ‚Ğ¾Ğ¼  atom  âœ“
atomic 		Ğ°Ñ‚Ğ¾Ğ¼Ğ½Ñ‹Ğ¹  atomnÄ—iy  âœ“
atomic theory 		Ğ°Ñ‚Ğ¾Ğ¼Ğ¸ÑÑ‚Ğ¸ĞºĞ°  atomistika  âœ“
atom bomb 		Ğ°Ñ‚Ğ¾Ğ¼Ğ½Ğ°Ñ Ğ±Ğ¾Ğ¼Ğ±Ğ°  atomnaia bomba  âœ“
attachÃ© 		Ğ°Ñ‚Ñ‚Ğ°ÑˆĞµ  attashe  âœ“
attack 		Ğ°Ñ‚Ğ°ĞºĞ¾Ğ²Ğ°Ñ‚ÑŒ  atakovat âœ“
attacker 		Ğ°Ğ³Ñ€ĞµÑÑĞ¾Ñ€  agressor âœ“

attend 		Ğ¿Ğ¾ÑĞµÑ‰Ğ°Ñ‚ÑŒ Ğ¿Ğ¾ÑĞµÑ‚Ğ¸Ñ‚ÑŒ  poseschat posetit  <<  pro.sit?
at home 		Ğ´Ğ¾Ğ¼Ğ°  doma  âœ“ +++++ EN!!! => Greek => *

at present 		Ñ‚ĞµĞ¿ĞµÑ€ÑŒ  teper  <<
at that place 		Ñ‚Ğ°Ğ¼  tam  da~ âœ“ <<
auction 		Ğ°ÑƒĞºÑ†Ğ¸Ğ¾Ğ½  aukssion  âœ“
audience 		Ğ°ÑƒĞ´Ğ¸Ñ‚Ğ¾Ñ€Ğ¸Ñ  auditoriia 
auditory 		Ğ°ÑƒĞ´Ğ¸Ñ‚Ğ¾Ñ€Ğ¸Ñ  auditoriia  âœ“
aunt 		Ñ‚Ñ‘Ñ‚Ñ  tÑ‘tia  Tante ++
author 		Ğ°Ğ²Ñ‚Ğ¾Ñ€  avtor  âœ“
authority 		Ğ°Ğ²Ñ‚Ğ¾Ñ€Ğ¸Ñ‚ĞµÑ‚  avtoritet  âœ“
autobus 		Ğ°Ğ²Ñ‚Ğ¾Ğ±ÑƒÑ  avtobus  âœ“
autogenous 		Ğ°Ğ²Ñ‚Ğ¾Ğ³ĞµĞ½Ğ½Ñ‹Ğ¹  avtogennÄ—iy  âœ“
automate 		Ğ°Ğ²Ñ‚Ğ¾Ğ¼Ğ°Ñ‚Ğ¸Ğ·Ğ¸Ñ€Ğ¾Ğ²Ğ°Ñ‚ÑŒ  avtomatiÅ›irovat 
automatic 		Ğ°Ğ²Ñ‚Ğ¾Ğ¼Ğ°Ñ‚Ğ¸Ñ‡ĞµÑĞºĞ¸Ğ¹  avtomaticheskiy 
automoton 		Ğ°Ğ²Ñ‚Ğ¾Ğ¼Ğ°Ñ‚  avtomat  âœ“
autonomic 		Ğ°Ğ²Ñ‚Ğ¾Ğ½Ğ¾Ğ¼Ğ½Ñ‹Ğ¹  avtonomnÄ—iy  âœ“
autonomous 		Ğ°Ğ²Ñ‚Ğ¾Ğ½Ğ¾Ğ¼Ğ½Ñ‹Ğ¹  avtonomnÄ—iy  âœ“
autonomy 		Ğ°Ğ²Ñ‚Ğ¾Ğ½Ğ¾Ğ¼Ğ¸Ñ  avtonomiia  âœ“
autumn 		Ğ¾ÑĞµĞ½ÑŒ  osen  ~âœ“ - <<
avantâ€garde 		Ğ°Ğ²Ğ°Ğ½Ğ³Ğ°Ñ€Ğ´  avangard  âœ“
avenue 		Ğ°Ğ»Ğ»ĞµÑ  alleia âœ“
aversion 		Ğ°Ğ½Ñ‚Ğ¸Ğ¿Ğ°Ñ‚Ğ¸Ñ  antipatiia âœ“
aviation 		Ğ°Ğ²Ğ¸Ğ°Ñ†Ğ¸Ñ  aviassiia  âœ“

await 		Ğ¶Ğ´Ğ°Ñ‚ÑŒ Ğ¿Ğ¾Ğ´Ğ¾Ğ¶Ğ´Ğ°Ñ‚ÑŒ  Î¶edat podoÎ¶edat  <<<
awaken 		Ñ€Ğ°Ğ·Ğ±ÑƒĞ´Ğ¸Ñ‚ÑŒ  raÅ›budit  Â¬raÅ›en :) <<

awkward 		Ğ°Ğ»ÑĞ¿Ğ¾Ğ²Ğ°Ñ‚Ñ‹Ğ¹  aliapovatÄ—iy   alien?<<

bad 		Ğ¿Ğ»Ğ¾Ñ…Ğ¾Ğ¹  ploxoy <<
badly 		Ğ¿Ğ»Ğ¾Ñ…Ğ¾  ploxo 

badger 		Ğ±Ğ°Ñ€ÑÑƒĞº  barsuk  âœ“
baggage 		Ğ±Ğ°Ğ³Ğ°Ğ¶  bagaÎ¶e  âœ“

bairn 		Ñ€ĞµĞ±Ñ‘Ğ½Ğ¾Ğº  rebÑ‘nok  (das Kind?)  bÑ‘n~bairn~bin=son! <<
barn 		Ğ±ÑƒĞ´ĞºĞ°  budka  Bude ~âœ“

baker 		Ğ±ÑƒĞ»Ğ¾Ñ‡Ğ½Ğ¸Ğº  bulochnik  ?
balance sheet 		Ğ±Ğ°Ğ»Ğ°Ğ½Ñ  balans  âœ“
balcony 		Ğ±Ğ°Ğ»ĞºĞ¾Ğ½  balkon  âœ“
ball 		Ğ±Ğ°Ğ»  bal  âœ“
ballet 		Ğ±Ğ°Ğ»ĞµÑ‚  balet  âœ“
balloon 		Ğ°ÑÑ€Ğ¾ÑÑ‚Ğ°Ñ‚  aairostat ~âœ“
bamboo 		Ğ±Ğ°Ğ¼Ğ±ÑƒĞº  bambuk  âœ“
banana 		Ğ±Ğ°Ğ½Ğ°Ğ½  banan  âœ“
bandage 		Ğ±Ğ°Ğ½Ğ´Ğ°Ğ¶  bandaÎ¶e  âœ“
bank 		Ğ±Ğ°Ğ½Ğº  bank  âœ“
bankruptcy 		Ğ±Ğ°Ğ½ĞºÑ€Ğ¾Ñ‚ÑÑ‚Ğ²Ğ¾  bankrotstvo  âœ“
bank clerk 		Ğ±Ğ°Ğ½ĞºĞ¸Ñ€  bankir  âœ“
bank official 		Ğ±Ğ°Ğ½ĞºĞ¸Ñ€  bankir  âœ“
bar 		Ğ±Ğ°Ñ‚Ğ¾Ğ½  baton  ~âœ“?-

barefoot 		Ğ±Ğ¾ÑĞ¸ĞºĞ¾Ğ¼Ğ¾Ğ¹  bosikomoy <<

barge 		Ğ±Ğ°Ñ€Ğ¶Ğ°  barÎ¶ea  âœ“
barium 		Ğ±Ğ°Ñ€Ğ¸Ğ¹  bariy  âœ“
bark 		Ğ±Ñ€ĞµÑ…Ğ°Ñ‚ÑŒ  brexat ~âœ“-
barometer 		Ğ±Ğ°Ñ€Ğ¾Ğ¼ĞµÑ‚Ñ€  barometr  âœ“
barren 		Ğ±ĞµÑĞ¿Ğ»Ğ¾Ğ´Ğ½Ñ‹Ğ¹  besplodnÄ—iy 
barricade 		Ğ±Ğ°Ñ€Ñ€Ğ¸ĞºĞ°Ğ´Ğ¸Ñ€Ğ¾Ğ²Ğ°Ñ‚ÑŒ  barrikadirovat 
barrier 		Ğ±Ğ°Ñ€ÑŒĞµÑ€  barer  âœ“
barrister 		Ğ°Ğ´Ğ²Ğ¾ĞºĞ°Ñ‚  advokat  âœ“
base 		Ğ±Ğ°Ğ·Ğ¸Ñ€Ğ¾Ğ²Ğ°Ñ‚ÑŒ  baÅ›iâœ“rovat?
basin 		Ğ±Ğ°ÑÑĞµĞ¹Ğ½  basseyn  âœ“
bass 		Ğ±Ğ°Ñ  bas  âœ“
bass voice 		Ğ±Ğ°Ñ  bas âœ“
bathroom 		Ğ±Ğ°Ğ½Ñ  bania âœ“! <<
baths superintendant 		Ğ±Ğ°Ğ½Ñ‰Ğ¸Ğº  banâœ“schik!? <<
battalion 		Ğ±Ğ°Ñ‚Ğ°Ğ»ÑŒĞ¾Ğ½  batalon  âœ“
battery 		Ğ°ĞºĞºÑƒĞ¼ÑƒĞ»ÑÑ‚Ğ¾Ñ€  akkumuliator âœ“

battleâ€ 		Ğ±Ğ¾ĞµĞ²Ğ¾Ğ¹  boevoy ~âœ“ <<
battle 		Ğ±Ğ¾ĞµĞ²Ğ¾Ğ¹  boevoy 

bay 		Ğ±ÑƒÑ…Ñ‚Ğ°  buxta  Bucht âœ“
bazaar 		Ğ±Ğ°Ğ·Ğ°Ñ€  baÅ›ar  âœ“
be 		Ğ±Ñ‹Ñ‚ÑŒ  bÄ—it âœ“!!! bist/seid
bead 		Ğ±ÑƒÑĞ¸Ğ½Ğ°  busina ~âœ“
beam 		Ğ±Ğ°Ğ»ĞºĞ° Ğ±Ñ€ĞµĞ²Ğ½Ğ¾ Ğ±Ñ€ÑƒÑ  balka[n]âœ“ brevno brus?
bean 		Ğ±Ğ¾Ğ±  bob  âœ“? ;)
beard 		Ğ±Ğ¾Ñ€Ğ¾Ğ´Ğ°  boroda  âœ“
beat 		Ğ±Ğ¸Ñ‚ÑŒ  bit  âœ“
beaver 		Ğ±Ğ¾Ğ±Ñ€Ğ¾Ğ²Ñ‹Ğ¹  bobrovÄ—iy  ~âœ“

beautiful 		ĞºÑ€Ğ°ÑĞ¸Ğ²Ñ‹Ğ¹  krasivÄ—iy  <<< ! ÑĞ¸Ğ²Ñ‹Ğ¹ ~ schÃ¶nfair!! <<<<<


because of 		Ğ¸Ğ·â€Ğ·Ğ°  iÅ›â€Å›a  <<

become 		Ğ±Ñ‹Ñ‚Ğ¾Ğ²Ğ°Ñ‚ÑŒ  bÄ—itovat ~~âœ“ <<
bed 		Ğ¿Ğ¾ÑÑ‚ĞµĞ»ÑŒ  postel <<+?
bedroom 		ÑĞ¿Ğ°Ğ»ÑŒĞ½Ñ  spalnia ?

beech 		Ğ±ÑƒĞº  buk  âœ“
beefsteak 		Ğ±Ğ¸Ñ„ÑˆÑ‚ĞµĞºÑ  bifshteks  âœ“


behind 		Ğ·Ğ°  Å›a <<
behold 		Ğ²Ğ¾Ñ‚  vot  voiet! âœ“ <<

beginning 		Ğ½Ğ°Ñ‡Ğ°Ğ»Ğ¾  nachalo <<<?
below 		Ğ²Ğ½Ğ¸Ğ·Ñƒ  vniÅ›u <<?
beside 		Ğ¾ĞºĞ¾Ğ»Ğ¾ Ñƒ  okolo u <<?
beyond 		Ğ¿Ğ¾Ğ¿ĞµÑ€Ñ‘Ğº  poperÑ‘k <<?
<<<<<<<<<<<<<<<<<

between 		Ğ¼ĞµĞ¶Ğ´Ñƒ  meÎ¶edu  âœ“  mitween mitten imbetween !! AMBI <<

better 		Ğ»ÑƒÑ‡ÑˆĞµ  luchshe << lux?
best 		Ğ»ÑƒÑ‡ÑˆĞ¸Ğ¹  luchshiy 

belly 		Ğ±Ñ€ÑÑ…Ğ¾  bruxo ~~ Brust âœ“ << 

be able to 		Ğ¼Ğ¾Ñ‡ÑŒ  moch   << macht +

be acquainted with 		Ğ·Ğ½Ğ°Ñ‚ÑŒ  Å›nat ~~~ beCannt -- ?

be afraid of 		Ğ±Ğ¾ÑÑ‚ÑŒÑÑ Ğ¿Ğ¾Ğ±Ğ¾ÑÑ‚ÑŒÑÑ  boiatsia poboiatsia  phobie++ âœ“
be alive 		Ğ¶Ğ¸Ñ‚ÑŒ Ğ¿Ñ€Ğ¾Ğ¶Ğ¸Ñ‚ÑŒ  Î¶eit proÎ¶eit  <<< seiet!
be called 		Ğ½Ğ°Ğ·Ñ‹Ğ²Ğ°Ñ‚ÑŒÑÑ Ğ½Ğ°Ğ·Ğ²Ğ°Ñ‚ÑŒÑÑ  naÅ›Ä—ivatsia naÅ›vatsia  << (sch)natter!
be obstinate 		Ğ°Ñ€Ñ‚Ğ°Ñ‡Ğ¸Ñ‚ÑŒÑÑ  artachitsia 
be stubborn 		Ğ°Ñ€Ñ‚Ğ°Ñ‡Ğ¸Ñ‚ÑŒÑÑ  artachitsia 
be willing to 		Ñ…Ğ¾Ñ‚ĞµÑ‚ÑŒ Ğ·Ğ°Ñ…Ğ¾Ñ‚ĞµÑ‚ÑŒ  xotet Å›axotet <<?

big 		Ğ±Ğ¾Ğ»ÑŒÑˆĞ¾Ğ¹  bolshoy âœ“ !!! bolshevik? <<<
bible 		Ğ±Ğ¸Ğ±Ğ»Ğ¸Ñ  bibliia  âœ“
bill 		Ğ±Ğ¸Ğ»ĞµÑ‚  bilet  âœ“
billiards 		Ğ±Ğ¸Ğ»ÑŒÑÑ€Ğ´  biliard  âœ“
binoculars 		Ğ±Ğ¸Ğ½Ğ¾ĞºĞ»ÑŒ  binokl  âœ“
birch 		Ğ±ĞµÑ€Ñ‘Ğ·Ğ°  berÑ‘Å›a ~âœ“
bishop 		Ğ°Ñ€Ñ…Ğ¸ĞµÑ€ĞµĞ¹  arxierey  ArchHiery! âœ“ <<

black 		Ñ‡Ñ‘Ñ€Ğ½Ñ‹Ğ¹  chÑ‘rnÄ—iy  char coal chermn khem!! << <>
blue 		ÑĞ¸Ğ½Ğ¸Ğ¹  siniy cyan! ++ âœ“ <<
blueberry 		Ñ‡ĞµÑ€Ğ½Ğ¸ĞºĞ°  chernika <- cyan

blank 		Ğ±ĞµĞ»Ñ‹Ğ¹  belÄ—iy  âœ“    Ğ¹ : ink->ing->yny->y ! ++

blasphemy 		Ğ±Ğ¾Ğ³Ğ¾Ñ…ÑƒĞ»ÑŒÑÑ‚Ğ²Ğ¾  bogoxulstvo ?
bless 		Ğ±Ğ»Ğ°Ğ³Ğ¾ÑĞ»Ğ¾Ğ²Ğ»ÑÑ‚ÑŒ Ğ±Ğ»Ğ°Ğ³Ğ¾ÑĞ»Ğ¾Ğ²Ğ¸Ñ‚ÑŒ  blagoslovliat blagoslovit ?
blessing 		Ğ±Ğ»Ğ°Ğ³Ğ¾ÑĞ»Ğ¾Ğ²ĞµĞ½Ğ¸Ğµ  blagoslovenie ?

blockade 		Ğ±Ğ»Ğ¾ĞºĞ°Ğ´Ğ°  blokada  âœ“
blond 		Ğ±ĞµĞ»Ğ¾ĞºÑƒÑ€Ñ‹Ğ¹  belokurÄ—iy   bello blank-hair! << 
blouse 		Ğ±Ğ»ÑƒĞ·Ğ°  bluÅ›a  âœ“

blunt 		Ñ‚ÑƒĞ¿Ğ¾Ğ¹  tupoy ?
blush 		Ğ°Ğ»ĞµÑ‚ÑŒ Ğ±Ğ°Ğ³Ñ€Ğ¾Ğ²ĞµÑ‚ÑŒ  alet bagrovet ?
blushing 		ĞºÑ€Ğ°ÑĞ½Ñ‹Ğ¹  krasnÄ—iy ?
board 		Ğ·Ğ°Ğ±Ğ¸Ñ€Ğ°Ñ‚ÑŒ Ğ·Ğ°Ğ±Ñ€Ğ°Ñ‚ÑŒ  Å›abirat Å›abrat  the'board;) << âœ“? ;)
boat 		Ğ»Ğ¾Ğ´ĞºĞ°  lodka  lodge:wood?  <<

body 		Ñ‚ĞµĞ»Ğ¾ Ñ‚ÑƒĞ»Ğ¾Ğ²Ğ¸Ñ‰Ğµ  telo tulovische << Teil?

bomb 		Ğ±Ğ¾Ğ¼Ğ±Ğ°  bomba  âœ“
bone 		ĞºĞ¾ÑÑ‚ÑŒ  kost  keras?
bookâ€keeper 		Ğ±ÑƒÑ…Ğ³Ğ°Ğ»Ñ‚ĞµÑ€  buxgalter BuchHalter !! âœ“ DE <3
bookâ€keeping 		Ğ±ÑƒÑ…Ğ³Ğ°Ğ»Ñ‚ĞµÑ€Ğ¸Ñ  buxgalteriia 

book 		ĞºĞ½Ğ¸Ğ³Ğ°  kniga  'Knigge' <3 âœ“? ;)   Knick vs Buchs-Busch!! <<<

bookcase 		ĞºĞ½Ğ¸Ğ¶Ğ½Ñ‹Ğ¹ ÑˆĞºĞ°Ñ„  kniÎ¶enÄ—iy shcathe / shcover <<!
bookshop 		ĞºĞ½Ğ¸Ğ¶Ğ½Ñ‹Ğ¹ Ğ¼Ğ°Ğ³Ğ°Ğ·Ğ¸Ğ½  kniÎ¶enÄ—iy magaÅ›in 
bookstore 		ĞºĞ½Ğ¸Ğ¶Ğ½Ñ‹Ğ¹ Ğ¼Ğ°Ğ³Ğ°Ğ·Ğ¸Ğ½  kniÎ¶enÄ—iy magaÅ›in 

boon 		Ğ±Ğ»Ğ°Ğ³Ğ¾ÑĞ»Ğ¾Ğ²ĞµĞ½Ğ¸Ğµ  blagoslovenie   Â¬Plage! <<

borax 		Ğ±ÑƒÑ€Ğ°  bura  âœ“
bore 		Ğ±ÑƒÑ€Ğ°Ğ²Ğ¸Ñ‚ÑŒ  buravit âœ“
boron 		Ğ±Ğ¾Ñ€  bor  âœ“
boss 		ĞºĞ°Ğ¿Ğ¸Ñ‚Ğ°Ğ½  kapitan âœ“
botany 		Ğ±Ğ¾Ñ‚Ğ°Ğ½Ğ¸ĞºĞ°  botanika  âœ“

both 		Ğ¾Ğ±Ğ° Ğ¾Ğ±Ğµ  oba obe ~~âœ“ <<+? o'beide

bottle 		Ğ±ÑƒÑ‚Ñ‹Ğ»ĞºĞ°  butÄ—ilka âœ“
boulevard 		Ğ±ÑƒĞ»ÑŒĞ²Ğ°Ñ€  bulvar  âœ“
bourgeois 		Ğ±ÑƒÑ€Ğ¶ÑƒĞ°Ğ·Ğ½Ñ‹Ğ¹  burÎ¶euaÅ›nÄ—iy âœ“
bourgeoisie 		Ğ±ÑƒÑ€Ğ¶ÑƒĞ°Ğ·Ğ¸Ñ  burÎ¶euaÅ›iia âœ“
boutique 		Ğ¼Ğ°Ğ³Ğ°Ğ·Ğ¸Ğ½  magaÅ›in âœ“
bow 		Ğ°Ñ€ĞºĞ°  arka âœ“ !
box 		Ğ±Ğ¾ĞºÑĞ¸Ñ€Ğ¾Ğ²Ğ°Ñ‚ÑŒ  boksâœ“irovat?
boxer 		Ğ±Ğ¾ĞºÑÑ‘Ñ€  boksÑ‘r  âœ“
brace 		Ğ°Ñ€Ğ¼Ğ°Ñ‚ÑƒÑ€  armatur âœ“
bracelet 		Ğ±Ñ€Ğ°ÑĞ»ĞµÑ‚  braslet  âœ“
braille 		Ğ°Ğ·Ğ±ÑƒĞºĞ° Ğ´Ğ»Ñ ÑĞ»ĞµĞ¿Ñ‹Ñ…  aÅ›buka dlia slepÄ—ix ??

brain 		Ğ¼Ğ¾Ğ·Ğ³  moÅ›g <<< moÅ›en;) ?? Moskau~capital !?! <<<<
bridge 		Ğ¼Ğ¾ÑÑ‚  most <<< ?  pons@brain

broad 		ÑˆĞ¸Ñ€Ğ¾ĞºĞ¸Ğ¹  shirokiy <<?? <>
 spread?
brave 		Ğ±Ñ€Ğ°Ğ²Ñ‹Ğ¹  bravÄ—iy  âœ“
breach 		Ğ±Ñ€ĞµÑˆÑŒ  bresh  âœ“
bread and butter 		Ğ±ÑƒÑ‚ĞµÑ€Ğ±Ñ€Ğ¾Ğ´  buterbrod âœ“

brigade 		Ğ±Ñ€Ğ¸Ğ³Ğ°Ğ´Ğ°  brigada  âœ“
bring along 		Ğ·Ğ°Ğ±Ğ¸Ñ€Ğ°Ñ‚ÑŒ Ğ·Ğ°Ğ±Ñ€Ğ°Ñ‚ÑŒ  Å›abirat Å›abrat ~~ zu-bringt <<
bronze 		Ğ±Ñ€Ğ¾Ğ½Ğ·Ğ¾Ğ²Ñ‹Ğ¹  bronÅ›oâœ“vÄ—iy âœ“
brother 		Ğ±Ñ€Ğ°Ñ‚  brat  âœ“
brow 		Ğ±Ñ€Ğ¾Ğ²ÑŒ  brov  âœ“
buffalo 		Ğ±ÑƒĞ¹Ğ±Ğ¾Ğ»  buybol  ~âœ“ !! <<

buffer 		Ğ±ÑƒÑ„ĞµÑ€  bufher  âœ“
bumper 		Ğ±ÑƒÑ„ĞµÑ€  buffer  âœ“ ++

building 		Ğ·Ğ´Ğ°Ğ½Ğ¸Ğµ  Å›danie <<?
burdensome 		Ñ‚ÑĞ¶Ñ‘Ğ»Ñ‹Ğ¹  tiaÎ¶eÑ‘lÄ—iy ?
busy 		Ğ·Ğ°Ğ½Ğ¸Ğ¼Ğ°Ñ‚ÑŒÑÑ  Å›animatsia s'animated ~âœ“

buffoon 		Ğ°Ñ€Ğ»ĞµĞºĞ¸Ğ½  arlekin âœ“
bull 		Ğ±Ñ‹Ğº  bÄ—ik  âœ“
buoy 		Ğ±ÑƒĞ¹  buy  âœ“
bus 		Ğ°Ğ²Ñ‚Ğ¾Ğ±ÑƒÑ  avtobus âœ“

business 		Ğ´ĞµĞ»Ğ¾  delo sell! tell? <<  âœ“/2
business deal 		Ğ´ĞµĞ»Ğ¾  delo 
case 		Ğ´ĞµĞ»Ğ¾  delo  <<^^

but 		Ğ°  a  âœ“ allo aber
by 		Ğ¾ĞºĞ¾Ğ»Ğ¾ Ñƒ  okolo u  "Ã " <<
by now 		ÑƒĞ¶Ğµ  uÎ¶ee  : as(of now) ~~ âœ“ <<

butterfly 		Ğ±Ğ°Ğ±Ğ¾Ñ‡ĞºĞ°  babochka  ~~ <<
button 		Ğ±ÑƒÑ‚Ğ¾Ğ½  buton  âœ“
buy 		Ğ¿Ğ¾ĞºÑƒĞ¿Ğ°Ñ‚ÑŒ ĞºÑƒĞ¿Ğ¸Ñ‚ÑŒ  pokupat kupit kaufet âœ“~! << 

cabinet 		ÑˆĞºĞ°Ñ„  shkath shcabhe Ñˆcover !!  Ñˆcabi.net <<
closet 			ÑˆĞºĞ°Ñ„  shkath  Ñˆcover 


call 		Ğ½Ğ°Ğ·Ñ‹Ğ²Ğ°Ñ‚ÑŒ Ğ½Ğ°Ğ·Ğ²Ğ°Ñ‚ÑŒ  naÅ›Ä—ivat naÅ›vat (sch)natter <<<
caller 		Ğ¿Ğ¾ÑĞµÑ‚Ğ¸Ñ‚ĞµĞ»ÑŒ  posetitel ?
call on 		Ğ¿Ğ¾ÑĞµÑ‰Ğ°Ñ‚ÑŒ Ğ¿Ğ¾ÑĞµÑ‚Ğ¸Ñ‚ÑŒ  poseschat posetit ??

can 		Ğ±Ğ°Ğ½ĞºĞ°  banka  'âœ“' <<< permute + ___ ???  ban=do ka[n]=work !<<

canal 		ĞºĞ°Ğ½Ğ°Ğ»  kanal  âœ“
candidate 		Ğ°ÑĞ¿Ğ¸Ñ€Ğ°Ğ½Ñ‚  aspirant  âœ“
canoe 		Ğ±Ğ°Ğ¹Ğ´Ğ°Ñ€ĞºĞ°  baydarka ?
canteen 		Ğ±Ğ°ĞºĞ»Ğ°Ğ³Ğ°  baklaga ?
capable 		ÑĞ¿Ğ¾ÑĞ¾Ğ±Ğ½Ñ‹Ğ¹  sposobnÄ—iy ??
car 		Ğ°Ğ²Ñ‚Ğ¾Ğ¼Ğ°ÑˆĞ¸Ğ½Ğ° Ğ°Ğ²Ñ‚Ğ¾Ğ¼Ğ¾Ğ±Ğ¸Ğ»ÑŒ  avtomashina avtomobil âœ“
card 		ĞºĞ°Ñ€Ñ‚Ğ°  karta  âœ“
carpet 		ĞºĞ¾Ğ²Ñ‘Ñ€  kovÑ‘r âœ“ !
castle 		Ğ±Ğ°ÑˆĞ½Ñ  bashnia  ~ bastion? âœ“?

chasm 		Ğ±ĞµĞ·Ğ´Ğ½Ğ°  Ğ±ĞµÅ›-dna  <> <<
catastrophe 		Ğ±ĞµĞ´Ğ° Ğ±ĞµĞ´ÑÑ‚Ğ²Ğ¸Ğµ  beda bedstvie   BADâœ“__?
catastrophic 		Ğ±ĞµĞ´ÑÑ‚Ğ²ĞµĞ½Ğ½Ñ‹Ğ¹  bedstvennÄ—iy 
chaos 		Ğ±ĞµÑĞ¿Ğ¾Ñ€ÑĞ´Ğ¾Ğº  besporiadok <<< ^^   hesperion?
chaotic 		Ğ±ĞµÑĞ¿Ğ¾Ñ€ÑĞ´Ğ¾Ñ‡Ğ½Ñ‹Ğ¹  besporiadochnÄ—iy 

catch 		Ğ±Ğ¸Ñ‚ÑŒ ÑƒĞ´Ğ°Ñ€Ğ¸Ñ‚ÑŒ  bit udarit  featch ___? 
caviar 		Ğ¸ĞºÑ€Ğ°  ikra -

century 		Ğ²ĞµĞº  vek  ??   â‰  hundred 		ÑÑ‚Ğ¾  sto
centennial 		Ğ²ĞµĞº  vek 

certificate 		Ğ°ĞºÑ‚  akt[e] âœ“ 
chair 		ÑÑ‚ÑƒĞ»  stul âœ“
chamber 		ĞºĞ¾Ğ¼Ğ½Ğ°Ñ‚Ğ°  komnata âœ“
channel 		ĞºĞ°Ğ½Ğ°Ğ»  kanal  âœ“
charity 		Ğ¼Ğ¸Ğ»Ğ¾ÑÑ‚Ñ‹Ğ½Ñ  milostÄ—inia  <> mild? <<
cheap 		Ğ´ĞµÑˆÑ‘Ğ²Ñ‹Ğ¹  deshÑ‘vÄ—iy ~ decheap <<

cheat 		Ğ±ĞµÑÑ‚Ğ¸Ñ  bestiia bestechen baschik <<<

cheese 		ÑÑ‹Ñ€  sÄ—ir ~~ -
chemist 		Ğ°Ğ¿Ñ‚ĞµĞºĞ°Ñ€ÑŒ  aptekar  apotheker âœ“
chemist's shop 		Ğ°Ğ¿Ñ‚ĞµĞºĞ°  apteka apotheke âœ“
chief 		ĞºĞ°Ğ¿Ğ¸Ñ‚Ğ°Ğ½  kapitan âœ“
child 		Ñ€ĞµĞ±Ñ‘Ğ½Ğ¾Ğº  rebÑ‘nok âœ“ bin:Bengel! rebe vs rabbi! vs REN! rein:  young, fresh   ğ“‚‹  ğ“ˆ–  ğ“Šª  ğ“…± ğ“†¶  ğ“ 
childless 		Ğ±ĞµĞ·Ğ´ĞµÑ‚Ğ½Ñ‹Ğ¹  Ğ±ĞµÅ›-detnÄ—iy ^^?

choose 		Ğ²Ñ‹Ğ±Ğ¸Ñ€Ğ°Ñ‚ÑŒ Ğ²Ñ‹Ğ±Ñ€Ğ°Ñ‚ÑŒ  vÄ—ibirat vÄ—ibrat  <<
chord 		Ğ°ĞºĞºĞ¾Ñ€Ğ´  akkord  âœ“
chorus 		Ñ…Ğ¾Ñ€  xor  âœ“
chunk 		Ğ±ÑƒĞ»ĞºĞ°  bulka  âœ“
cigarette 		Ğ¿Ğ°Ğ¿Ğ¸Ñ€Ğ¾ÑĞ° ÑĞ¸Ğ³Ğ°Ñ€ĞµÑ‚Ğ°  papirosa sigareta âœ“
cinema 		ĞºĞ¸Ğ½Ğ¾  kino  âœ“
circle 		Ğ°ÑÑĞ¾Ñ†Ğ¸Ğ°Ñ†Ğ¸Ñ  assossiassiia ~âœ“ Æ’
city 		Ğ³Ğ¾Ñ€Ğ¾Ğ´  gorod KurOrt qvart âœ“âœ“âœ“ !!! +++
class 		ĞºĞ»Ğ°ÑÑ  klass  âœ“
climate 		ĞºĞ»Ğ¸Ğ¼Ğ°Ñ‚  klimat  âœ“

clean 		Ñ‡Ğ¸ÑÑ‚Ñ‹Ğ¹  chistÄ—iy   chysm? <<
clear 		ÑÑ€ĞºĞ¸Ğ¹  iarkiy <<
clergyman 		Ğ±Ğ°Ñ‚ÑÑˆĞºĞ°  batÑshka /
client 		Ğ¿Ğ¾ĞºÑƒĞ¿Ğ°Ñ‚ĞµĞ»ÑŒ  pokupatel ?
climb 		Ğ¿Ğ¾Ğ´Ğ½Ğ¸Ğ¼Ğ°Ñ‚ÑŒÑÑ Ğ¿Ğ¾Ğ´Ğ½ÑÑ‚ÑŒÑÑ  podnimatsia podniatsia  pod+___ <<
clippings 		Ğ±Ñ€Ğ°Ğº  brak  ?
clock 		Ñ‡Ğ°ÑÑ‹  chasÄ—i ~? -- 
clod 		Ğ±ÑƒĞ»ĞºĞ°  bulka ?
clothe 		Ğ¾Ğ´ĞµĞ²Ğ°Ñ‚ÑŒ Ğ¾Ğ´ĞµÑ‚ÑŒ  odevat odet ~-
cloud 		Ğ¾Ğ±Ğ»Ğ°ĞºĞ¾  oblako <> opaque? 
coarse 		Ğ°Ğ»ÑĞ¿Ğ¾Ğ²Ğ°Ñ‚Ñ‹Ğ¹  aliapovatÄ—iy 

coastâ€ 		Ğ±ĞµÑ€ĞµĞ³Ğ¾Ğ²Ğ¾Ğ¹  beregovoy 
coast 		Ğ±ĞµÑ€ĞµĞ³Ğ¾Ğ²Ğ¾Ğ¹  beregovoy 
coastal 		Ğ±ĞµÑ€ĞµĞ³Ğ¾Ğ²Ğ¾Ğ¹  beregovoy 

close 		Ğ·Ğ°ĞºÑ€Ñ‹Ğ²Ğ°Ñ‚ÑŒ Ğ·Ğ°ĞºÑ€Ñ‹Ñ‚ÑŒ  Å›akrÄ—ivat Å›akrÄ—it zu-greifen ++ âœ“ <<<!
club 		ĞºĞ»ÑƒĞ±  klub  âœ“
coir 		Ñ…Ğ¾Ñ€  xor  âœ“
collect 		ÑĞ¾Ğ±Ğ¸Ñ€Ğ°Ñ‚ÑŒ ÑĞ¾Ğ±Ñ€Ğ°Ñ‚ÑŒ  sobirat sobrat 
college 		Ğ»ĞµĞºÑ†Ğ¸Ñ  lekssiia âœ“ ++

colony 		Ğ°ÑƒĞ»  aul << alle?

come about 		Ğ±Ñ‹Ñ‚Ğ¾Ğ²Ğ°Ñ‚ÑŒ  bÄ—itovat << +?
come into 		Ğ²Ñ…Ğ¾Ğ´Ğ¸Ñ‚ÑŒ Ğ²Ğ¾Ğ¹Ñ‚Ğ¸  vxodit voyti for__<<

command 		Ğ¿Ñ€Ğ¸ĞºĞ°Ğ·  prikaÅ› 
commencement 		Ğ½Ğ°Ñ‡Ğ°Ğ»Ğ¾  nachalo 
concord 		Ğ°ĞºĞºĞ¾Ñ€Ğ´ ÑĞ¾Ğ³Ğ»Ğ°ÑĞ¸Ğµ ÑĞ¾Ğ¾Ñ‚Ğ²ĞµÑ‚ÑÑ‚Ğ²Ğ¸Ğµ  akkord soglasie sootvetstvie /
concurrence 		ÑĞ¾Ğ³Ğ»Ğ°ÑĞ¸Ğµ ÑĞ¾Ğ¾Ñ‚Ğ²ĞµÑ‚ÑÑ‚Ğ²Ğ¸Ğµ  soglasie sootvetstvie 
confront 		Ğ°Ñ€Ñ‚Ğ°Ñ‡Ğ¸Ñ‚ÑŒÑÑ  artachitsia 

competition 		Ğ¼Ğ°Ñ‚Ñ‡  match  Messen,MaÅ› <3 âœ“? <<
contest 		Ğ¼Ğ°Ñ‚Ñ‡  match MaÅ› âœ“

concerning 		Ğ¾  o  Ã  ++ âœ“    <> but

concert 		ĞºĞ¾Ğ½Ñ†ĞµÑ€Ñ‚  konssert  âœ“
concrete 		Ğ±ĞµÑ‚Ğ¾Ğ½  beton âœ“
condemn 		Ğ±Ñ€Ğ°ĞºĞ¾Ğ²Ğ°Ñ‚ÑŒ  brakovat ?
confiscate 		Ğ½Ğ°Ğ»Ğ¾Ğ¶Ğ¸Ñ‚ÑŒ Ğ°Ñ€ĞµÑÑ‚ Ğ½Ğ°  naloÎ¶eit? arestâœ“ na 
conifer forest 		Ğ±Ğ¾Ñ€  bor <> boreal wald
consent 		ÑĞ¾Ğ³Ğ»Ğ°ÑˆĞ°Ñ‚ÑŒÑÑ  soglashatsia  ?
consider 		ÑÑ‡Ğ¸Ñ‚Ğ°Ñ‚ÑŒ  schitat ? 
container 		Ğ±Ğ°Ğº  bak  box âœ“

continuous 		Ğ±ĞµĞ·Ğ¾ÑÑ‚Ğ°Ğ½Ğ¾Ğ²Ğ¾Ñ‡Ğ½Ñ‹Ğ¹ Ğ±ĞµÑĞ¿ĞµÑ€ĞµĞ±Ğ¾Ğ¹Ğ½Ñ‹Ğ¹  Ğ±ĞµÅ›-ostanovochnÄ—iy bespereboynÄ—iy 
contented 		Ğ´Ğ¾Ğ²Ğ¾Ğ»ÑŒĞ½Ñ‹Ğ¹  dovolnÄ—iy  <
contour 		Ğ°Ğ±Ñ€Ğ¸Ñ  abris  Abriss? <
copyright 		Ğ°Ğ²Ñ‚Ğ¾Ñ€ÑĞºĞ¾Ğµ Ğ¿Ñ€Ğ°Ğ²Ğ¾  avtorskoe pravo  author-privacy? << + âœ“/2
corner 		ÑƒĞ³Ğ¾Ğ»  ugol Eche/angle! âœ“âœ“ <<<
corps 		Ğ°Ñ€Ğ¼ĞµĞµÑ†ĞºĞ¾Ñ€Ğ¿ÑƒÑ  armeesskorpus âœ“
correct 		Ğ¿Ñ€Ğ°Ğ²Ğ¸Ğ»ÑŒĞ½Ñ‹Ğ¹  pravilnÄ—iy ?? <<
cost 		ÑÑ‚Ğ¾Ğ¸Ñ‚ÑŒ  stoit  ~âœ“-
costly 		Ğ´Ğ¾Ñ€Ğ¾Ğ³Ğ¾Ğ¹  dorogoy ?
counsel 		Ğ°Ğ´Ğ²Ğ¾ĞºĞ°Ñ‚  advokat âœ“
count 		ÑÑ‡Ğ¸Ñ‚Ğ°Ñ‚ÑŒ ÑĞ¾ÑÑ‡Ğ¸Ñ‚Ğ°Ñ‚ÑŒ  schitat soschitat zusam sysy.tat? << 
countless 		Ğ±ĞµÑÑ‡Ğ¸ÑĞ»ĞµĞ½Ğ½Ñ‹Ğ¹  beschislennÄ—iy des-^^ 

country 		Ğ´ĞµÑ€ĞµĞ²Ğ½Ñ  derevnia 
countryside 		Ğ´ĞµÑ€ĞµĞ²Ğ½Ñ  derevnia 

courageous 		Ğ±Ñ€Ğ°Ğ²Ñ‹Ğ¹  bravÄ—iy âœ“
course 		Ğ±Ğ»ÑĞ´Ğ¾  bluido plaÅ› âœ“
crampâ€iron 		Ğ°Ñ€Ğ¼Ğ°Ñ‚ÑƒÑ€  armatur âœ“~ ;) 

crazy 		Ğ±ĞµĞ·ÑƒĞ¼Ğ½Ñ‹Ğ¹  Ğ±ĞµÅ›-umnÄ—iy 
craziness 		Ğ±ĞµĞ·ÑƒĞ¼ÑÑ‚Ğ²Ğ¾  Ğ±ĞµÅ›-umstvo 
crook 		Ğ±ĞµÑÑ‚Ğ¸Ñ  bestiia âœ“
crude 		Ğ°Ğ»ÑĞ¿Ğ¾Ğ²Ğ°Ñ‚Ñ‹Ğ¹  aliapovatÄ—iy ^^

cry 		Ğ¿Ğ»Ğ°ĞºĞ°Ñ‚ÑŒ Ğ·Ğ°Ğ¿Ğ»Ğ°ĞºĞ°Ñ‚ÑŒ  plakat Å›aplakat ?

cupboard 		ÑˆĞºĞ°Ñ„  shcaph-board   !!! <<<

current 		Ğ°ĞºÑ‚ÑƒĞ°Ğ»ÑŒĞ½Ğ¾ÑÑ‚ÑŒ  aktualnost âœ“
customer 		Ğ¿Ğ¾ĞºÑƒĞ¿Ğ°Ñ‚ĞµĞ»ÑŒ  pokupatel ?
cuttings 		Ğ±Ñ€Ğ°Ğº  brak ?
daily paper 		Ğ³Ğ°Ğ·ĞµÑ‚Ğ°  gaÅ›eta âœ“
dance 		Ğ±Ğ°Ğ»  bal  âœ“
dark 		Ñ‚Ñ‘Ğ¼Ğ½Ñ‹Ğ¹  tÑ‘mnÄ—iy <> khemni  khe*min(2) !!!!!!!!!!!!!!!!!! <<<<<<<<<<<<<<<
date 		Ñ‡Ğ¸ÑĞ»Ğ¾  chislo ?? <
dear 		Ğ´Ğ¾Ñ€Ğ¾Ğ³Ğ¾Ğ¹  dorogoy ~ dearâœ“ogay~
decide 		Ñ€ĞµÑˆĞ°Ñ‚ÑŒ Ñ€ĞµÑˆĞ¸Ñ‚ÑŒ  reshat reshit  ~ desheid âœ“âœ“ <3

deem 		ÑĞ¼Ğ¾Ñ‚Ñ€ĞµÑ‚ÑŒ Ğ¿Ğ¾ÑĞ¼Ğ¾Ñ‚Ñ€ĞµÑ‚ÑŒ  smotret posmotret  pense.ma-treat as âœ“/2 ~~++--

defence 		Ğ°Ñ€ÑŒĞµÑ€Ğ³Ğ°Ñ€Ğ´  arer?gardâœ“  arier-guard?

descend 		ÑĞ¿ÑƒÑĞºĞ°Ñ‚ÑŒÑÑ ÑĞ¿ÑƒÑÑ‚Ğ¸Ñ‚ÑŒÑÑ  spuskatsia spustitsia 
description 		Ğ¾Ğ¿Ğ¸ÑĞ°Ğ½Ğ¸Ğµ  opisanie epi-/be-sanie ??
design 		Ğ¿Ğ»Ğ°Ğ½  plan âœ“
diagram 		Ğ¿Ğ»Ğ°Ğ½  plan âœ“ 
desire 		Ğ¶ĞµĞ»Ğ°Ñ‚ÑŒ Ğ¿Ğ¾Ğ¶ĞµĞ»Ğ°Ñ‚ÑŒ  Î¶eelat poÎ¶eelat ?
desperate 		Ğ±ĞµĞ·Ğ²Ñ‹Ñ…Ğ¾Ğ´Ğ½Ñ‹Ğ¹ Ğ±ĞµÅ›-vÄ—ixodnÄ—iy   bes-verxoid ~ desperate -
desperate Ğ±ĞµĞ·Ğ½Ğ°Ğ´Ñ‘Ğ¶Ğ½Ñ‹Ğ¹ Ğ±ĞµĞ·Ñ‹ÑÑ…Ğ¾Ğ´Ğ½Ñ‹Ğ¹   Ğ±ĞµÅ›-nadÑ‘Î¶enÄ—iy Ğ±ĞµÅ›-Ä—isxodnÄ—iy 
detention 		Ğ°Ñ€ĞµÑÑ‚  arest âœ“
device 		Ğ°Ğ¿Ğ¿Ğ°Ñ€Ğ°Ñ‚  apparat âœ“ 

devil 		Ğ±ĞµÑ  bes  âœ“ "ANTI"  <> Bes God @ EG? <<
divine 		Ğ±Ğ¾Ğ¶ĞµÑĞºĞ¸Ğ¹ Ğ±Ğ¾Ğ¶ĞµÑÑ‚Ğ²ĞµĞ½Ğ½Ñ‹Ğ¹  boÎ¶eeskiy boÎ¶eestvennÄ—iy tvennÄ—iy~devine ??? <<<<

diamond 		Ğ°Ğ»Ğ¼Ğ°Ğ·  almaÅ› <<
dictionary 		ÑĞ»Ğ¾Ğ²Ğ°Ñ€ÑŒ  slovar <<
dim 		Ñ‚Ñ‘Ğ¼Ğ½Ñ‹Ğ¹  tÑ‘mnÄ—iy ~âœ“
diningâ€room 		ÑÑ‚Ğ¾Ğ»Ğ¾Ğ²Ğ°Ñ  stolovaia 
diploma 		Ğ°ĞºÑ‚  akt âœ“
director 		Ğ´Ğ¸Ñ€ĞµĞºÑ‚Ğ¾Ñ€  direktor  âœ“
disapprove 		Ğ±Ñ€Ğ°ĞºĞ¾Ğ²Ğ°Ñ‚ÑŒ  brakovat ?
disapprove of 		Ğ±Ñ€Ğ°ĞºĞ¾Ğ²Ğ°Ñ‚ÑŒ  brakovat 
disease 		Ğ±Ğ¾Ğ»ĞµĞ·Ğ½ÑŒ  boleÅ›n 
dish 		Ğ±Ğ»ÑĞ´Ğ¾  bluido : plateâœ“
dislike 		Ğ°Ğ½Ñ‚Ğ¸Ğ¿Ğ°Ñ‚Ğ¸Ñ  antipatiia âœ“
dispose of 		Ğ¿Ñ€Ğ¾Ğ´Ğ°Ğ²Ğ°Ñ‚ÑŒ Ğ¿Ñ€Ğ¾Ğ´Ğ°Ñ‚ÑŒ  prodavat prodat âœ“? <<
dissect 		Ğ°Ğ½Ğ°Ñ‚Ğ¾Ğ¼Ğ¸Ñ€Ğ¾Ğ²Ğ°Ñ‚ÑŒ  anatomirovat âœ“
distinct 		ÑÑ€ĞºĞ¸Ğ¹  iarkiy  dia_? << -
do 		Ğ´ĞµĞ»Ğ°Ñ‚ÑŒ 	delat  <<<
do		ÑĞ´ĞµĞ»Ğ°Ñ‚ÑŒ  sdelat 
doctor 		Ğ²Ñ€Ğ°Ñ‡ Ğ´Ğ¾ĞºÑ‚Ğ¾Ñ€  vrach doktor âœ“
document 		Ğ°ĞºÑ‚  akt âœ“
dog 		ÑĞ¾Ğ±Ğ°ĞºĞ°  sobaka << 
door 		Ğ´Ğ²ĞµÑ€ÑŒ  dver  âœ“
doubt 		ÑĞ¾Ğ¼Ğ½ĞµĞ²Ğ°Ñ‚ÑŒÑÑ ÑƒÑĞ¾Ğ¼Ğ½Ğ¸Ñ‚ÑŒÑÑ  somnevatsia usomnitsia  ~âœ“? <<
down 		Ğ²Ğ½Ğ¸Ğ·  vniÅ› <<
downstairs 		Ğ²Ğ½Ğ¸Ğ·Ñƒ  vniÅ›u ^^
dress 		Ğ¾Ğ´ĞµĞ²Ğ°Ñ‚ÑŒ Ğ¾Ğ´ĞµÑ‚ÑŒ  odevat odet <> adret? <
drill 		Ğ±ÑƒÑ€Ğ°Ğ²Ğ¸Ñ‚ÑŒ  buravit âœ“ bohr
drivel 		Ğ±Ñ€ĞµÑ…Ğ°Ñ‚ÑŒ  brexat ( BlÃ¶dsinn ) /
drink 		Ğ¿Ğ¸Ñ‚ÑŒ Ğ²Ñ‹Ğ¿Ğ¸Ñ‚ÑŒ  pit vÄ—ipit <<
drugstore 		Ğ°Ğ¿Ñ‚ĞµĞºĞ°  apoteka âœ“ 
drum 		Ğ±Ğ°Ñ€Ğ°Ğ±Ğ°Ğ½  baraban ! ONO

during 		Ğ·Ğ° Ğ¿Ğ¾ĞºĞ°  Å›a poka <<
early 		Ñ€Ğ°Ğ½Ğ¾  rano  << RA.an raise

dwell 		Ğ¶Ğ¸Ñ‚ÑŒ Ğ¿Ğ¾Ğ¶Ğ¸Ñ‚ÑŒ  Î¶eit poÎ¶eit wohnZelt? Zeiten? <<

each 		Ğ²ÑĞµ ĞºĞ°Ğ¶Ğ´Ñ‹Ğ¹  vse kaÎ¶edÄ—iy  all <<
eager 		Ğ°Ğ»Ñ‡Ğ½Ñ‹Ğ¹  al.chnÄ—iy djini? << 
east 		Ğ²Ğ¾ÑÑ‚Ğ¾Ğº  vostok vosten vs vesten!! <<
easy 		Ğ»Ñ‘Ğ³ĞºĞ¸Ğ¹  lÑ‘gkiy <> leasyr 
eel 		ÑƒĞ³Ğ¾Ñ€ÑŒ  ugor /
eight 		Ğ²Ğ¾ÑĞµĞ¼ÑŒ  vosem ! 1?+7 ! past-7?
elder 		Ğ±ÑƒĞ·Ğ¸Ğ½Ğ°  buÅ›ina <<
elect 		Ğ²Ñ‹Ğ±Ğ¸Ñ€Ğ°Ñ‚ÑŒ Ğ²Ñ‹Ğ±Ñ€Ğ°Ñ‚ÑŒ  vÄ—ibirat vÄ—ibrat 
elements 		Ğ°Ğ·Ğ±ÑƒĞºĞ° Ğ°Ğ»Ñ„Ğ°Ğ²Ğ¸Ñ‚  aÅ›buka althavit  â‰  ABC WTF!
elephant 		ÑĞ»Ğ¾Ğ½  slon !! cylon schlange Nase <<

else 		Ğ´Ñ€ÑƒĞ³Ğ¾Ğ¹  drugoy 

encourage 		Ğ±Ğ¾Ğ´Ñ€Ğ¸Ñ‚ÑŒ  bodrit  be-druitâ€¦?

end 		ĞºĞ¾Ğ½ĞµÑ†  koness kend:kante+ness !!
ending 		ĞºĞ¾Ğ½ĞµÑ†  koness 

end up 		Ğ¿Ñ€Ğ¸Ğ±Ñ‹Ñ‚ÑŒ Ğ¿Ñ€Ğ¸Ğ±Ñ‹Ğ²Ğ°Ñ‚ÑŒ  pribÄ—it pribÄ—ivat  <<
engineer 		Ğ¸Ğ½Ğ¶ĞµĞ½ĞµÑ€  inÎ¶eener  âœ“
enter 		Ğ²Ñ…Ğ¾Ğ´Ğ¸Ñ‚ÑŒ Ğ²Ğ¾Ğ¹Ñ‚Ğ¸  vxodit voyti <<
enterprise 		Ğ·Ğ°Ğ²Ğ¾Ğ´  Å›avod 
equilibrium 		Ğ±Ğ°Ğ»Ğ°Ğ½Ñ  balans âœ“
equipment 		Ğ°Ğ¿Ğ¿Ğ°Ñ€Ğ°Ñ‚ÑƒÑ€Ğ°  apparatura âœ“
error 		Ğ¾ÑˆĞ¸Ğ±ĞºĞ°  oshibka <<

estate 		Ñ„ĞµÑ€Ğ¼Ğ°  perma / therma  terr.ma !!<<

esteem 		ÑÑ‡Ğ¸Ñ‚Ğ°Ñ‚ÑŒ  schitat âœ“ schÃ¤Å›en 

even 		Ğ´Ğ°Ğ¶Ğµ  daÎ¶ee ?
evening meal 		ÑƒĞ¶Ğ¸Ğ½  uÎ¶ein ?
ever 		Ğ²ÑĞµĞ³Ğ´Ğ°  vsegda ? [all]Ğ³Ğ´Ğ°

everything 		Ğ²ÑÑ‘  vsÑ‘  ??? <<< <> all vs bes=des-â€¦ wholes
everlasting 		Ğ±ĞµÑĞºĞ¾Ğ½ĞµÑ‡Ğ½Ñ‹Ğ¹ Ğ±ĞµÑĞºÑ€Ğ°Ğ¹Ğ½Ñ‹Ğ¹  beskonechnÄ—iy beskraynÄ—iy ?
every 		Ğ²ÑĞµ ĞºĞ°Ğ¶Ğ´Ñ‹Ğ¹  vse kaÎ¶edÄ—iy 
everybody 		Ğ²ÑĞµ ĞºĞ°Ğ¶Ğ´Ñ‹Ğ¹  vse kaÎ¶edÄ—iy 
every one 		Ğ²ÑĞµ ĞºĞ°Ğ¶Ğ´Ñ‹Ğ¹  vse kaÎ¶edÄ—iy 

exact 		Ğ¿Ñ€Ğ°Ğ²Ğ¸Ğ»ÑŒĞ½Ñ‹Ğ¹  pravilnÄ—iy ?

excise 		Ğ°ĞºÑ†Ğ¸Ğ·  akssiÅ› âœ“ exzidieren (schliÅ›en) ++?
exciseâ€duty 		Ğ°ĞºÑ†Ğ¸Ğ·  akssiÅ› besteuern <> Aktien?? ^^

exclusively 		Ñ‚Ğ¾Ğ»ÑŒĞºĞ¾  tolko  ?
exerciseâ€book 		Ñ‚ĞµÑ‚Ñ€Ğ°Ğ´ÑŒ  tetrad  4-square-ğŸ“•	âœ“
exercise 		ÑƒĞ¿Ñ€Ğ°Ğ¶Ğ½ĞµĞ½Ğ¸Ğµ  upraÎ¶enenie  +++ <<< ÑƒĞ¿Ñ€Ğ°Ğ¶Ğ½ĞµĞ½Ğ¸Ğµ uprĞ°.ghne* Ãœbung Ãœberung

expect 		Ğ¶Ğ´Ğ°Ñ‚ÑŒ Ğ¿Ğ¾Ğ´Ğ¾Ğ¶Ğ´Ğ°Ñ‚ÑŒ  Î¶edat podoÎ¶edat  profezeiht!?! <<<

expensive 		Ğ´Ğ¾Ñ€Ğ¾Ğ³Ğ¾Ğ¹  dorogoy <> way too reich? 

eye 		Ğ³Ğ»Ğ°Ğ·  gloÅ›  âœ“âœ“âœ“ LOL! <<
eyebrow 		Ğ±Ñ€Ğ¾Ğ²ÑŒ  brov  âœ“
facile 		Ğ»Ñ‘Ğ³ĞºĞ¸Ğ¹  lÑ‘gkiy  leichtâœ“ ! ++

fact 		Ñ„Ğ°ĞºÑ‚  fakt  âœ“
factory 		Ñ„Ğ°Ğ±Ñ€Ğ¸ĞºĞ° Ğ·Ğ°Ğ²Ğ¾Ğ´  Fabrika Å›avod 
farm 		Ñ„ĞµÑ€Ğ¼Ğ°  Ferma Perma therma terr! <<<

fade(v.2) 		Ğ±ĞµĞ»ĞµÑ‚ÑŒ Ğ±Ğ»ĞµĞ´Ğ½ĞµÑ‚ÑŒ  belet blednet (Ã¼ber)blenden âœ“
failure 		Ğ±Ğ°Ğ½ĞºÑ€Ğ¾Ñ‚ÑÑ‚Ğ²Ğ¾  bankrotstvo  âœ“ ;)
fair 		Ğ±Ğ°Ğ·Ğ°Ñ€  baÅ›ar 
family 		ÑĞµĞ¼ÑŒÑ  semia  âœ“
farmâ€ 		Ğ°Ğ³Ñ€Ğ°Ñ€Ğ½Ñ‹Ğ¹  agrarnÄ—iy âœ“
farmer 		Ğ°Ñ€ĞµĞ½Ğ´Ğ°Ñ‚Ğ¾Ñ€  arendator ^^?
farm out 		ÑĞ´Ğ°Ğ²Ğ°Ñ‚ÑŒ Ğ² Ğ°Ñ€ĞµĞ½Ğ´Ñƒ  sdavat v arendu 

fast 		Ğ±Ñ‹ÑÑ‚Ñ€Ñ‹Ğ¹  bÄ—istrÄ—iy  fÄ—ist fast +++<<

father 		Ğ¾Ñ‚ĞµÑ†  (v)oteÑ† !! <<<<<<  EARLY CORRUPTION!?:(  ATAF@EG!!! 

fear 		Ğ±Ğ¾ÑÑ‚ÑŒÑÑ Ğ¿Ğ¾Ğ±Ğ¾ÑÑ‚ÑŒÑÑ  boiatsia phoboiatsia âœ“
feather 		Ğ¿ĞµÑ€Ğ¾  pero   *Ñ„eÑ€Ğ¾ abero weather apropos!! <<<

female 		Ğ±Ğ°Ğ±Ğ¸Ğ¹  babiy ;) <3 !!! <<<

female student 		ÑÑ‚ÑƒĞ´ĞµĞ½Ñ‚ĞºĞ°  studentka âœ“
field 		Ğ¿Ğ¾Ğ»Ğµ  pole  âœ“
files 		Ğ°Ñ€Ñ…Ğ¸Ğ²  arxiv âœ“
fight 		Ğ±Ğ¾Ñ€Ğ¾Ñ‚ÑŒÑÑ  borotsia  warâ€¦ Borussia:))) <<<

find 		Ğ½Ğ°Ñ…Ğ¾Ğ´Ğ¸Ñ‚ÑŒ Ğ½Ğ°Ğ¹Ñ‚Ğ¸  naxodit nayti  <<<?? EG?

fine 		ĞºÑ€Ğ°ÑĞ¸Ğ²Ñ‹Ğ¹  krasivÄ—iy krass ~âœ“?

first name 		Ğ¸Ğ¼Ñ  imiaÑ Ğ¸Ğ¼Ñ:nomer "Reim" <<<<!!!! EG

first 		Ğ¿ĞµÑ€Ğ²Ñ‹Ğ¹  pervÄ—iy   per.vyek first ~~~ << <> private 1.polit
firstly 		ÑĞ½Ğ°Ñ‡Ğ°Ğ»Ğ°  snachala 
first of all 		ÑĞ½Ğ°Ñ‡Ğ°Ğ»Ğ°  snachala <<<??
five 		Ğ¿ÑÑ‚ÑŒ  piat  âœ“
flask 		Ğ±Ğ°ĞºĞ»Ğ°Ğ³Ğ°  baklaga  baglasche flask ~âœ“!<<
flat(n.) 		ĞºĞ²Ğ°Ñ€Ñ‚Ğ¸Ñ€Ğ°  kvartira quartier âœ“
flavour 		Ğ°Ñ€Ğ¾Ğ¼Ğ°Ñ‚  aromat âœ“
flea 		Ğ±Ğ»Ğ¾Ñ…Ğ°  bloxa  âœ“
flee 		Ğ±ĞµĞ¶Ğ°Ñ‚ÑŒ  beÎ¶eat = run ^^ âˆšpods feÅ›,fetz
float 		Ğ¿Ğ»Ğ°Ğ²Ğ°Ñ‚ÑŒ  plavat  âœ“
folder 		Ñ‚ĞµÑ‚Ñ€Ğ°Ğ´ÑŒ  tetrad  4?<<
fool 		Ğ±Ğ¾Ğ»Ğ²Ğ°Ğ½  bolvan << <3 fool.van
foolish 		Ğ³Ğ»ÑƒĞ¼Ñ‹Ğ¹  glumÄ—iy 
foot 		Ğ½Ğ¾Ğ³Ğ°  noga  ?
for 		Ğ·Ğ° Å›a zu âœ“
for			Ğ¿Ğ¾ĞºĞ°  poka ~~ for <<???
foreign 		Ğ¸Ğ½Ğ¾ÑÑ‚Ñ€Ğ°Ğ½Ğ½Ñ‹Ğ¹  in.ostran.nÄ—iy <> austral!? <<
forest 		Ğ»ĞµÑ  [fo]les  âœ“? lÃ­n:æ— Corrupt?
forgetful 		Ğ±ĞµÑĞ¿Ğ°Ğ¼ÑÑ‚Ğ½Ñ‹Ğ¹  bes.pamiat.nÄ—iy  des.formiert vs in.formiert <<<
fork 		Ğ²Ğ¸Ğ»ĞºĞ°  vilka ~~âœ“/3
form 		Ğ°Ğ½ĞºĞµÑ‚Ğ° Ğ±Ğ»Ğ°Ğ½Ğº  anketta(inquiry) / blank âœ“
for sake of 		Ğ¸Ğ·â€Ğ·Ğ°  iÅ›â€Å›a  ~~ as-so âœ“??
fountainâ€pen 		Ğ°Ğ²Ñ‚Ğ¾Ñ€ÑƒÑ‡ĞºĞ°  avto-ruchka ?
four 		Ñ‡ĞµÑ‚Ñ‹Ñ€Ğµ  chetÄ—ire  âœ“
fragrant 		Ğ°Ñ€Ğ¾Ğ¼Ğ°Ñ‚Ğ¸Ñ‡ĞµÑĞºĞ¸Ğ¹ Ğ°Ñ€Ğ¾Ğ¼Ğ°Ñ‚Ğ¸Ñ‡Ğ½Ñ‹Ğ¹  aromaticheskiy aromatichnÄ—iy âœ“
free 		Ğ±ĞµĞ·Ğ²Ğ¾Ğ·Ğ¼ĞµĞ·Ğ´Ğ½Ñ‹Ğ¹ Ğ±ĞµÑĞ¿Ğ»Ğ°Ñ‚Ğ½Ñ‹Ğ¹  Ğ±ĞµÅ›-voÅ›meÅ›dnÄ—iy bes-platnÄ—iy Â¬platt

friend 		Ğ´Ñ€ÑƒĞ³  drug;) drost,dost=2  <<! trag?

fright 		Ğ±Ğ¾ÑĞ·Ğ½ÑŒ  boiaÅ›n 
frindge 		Ğ±Ğ°Ñ…Ñ€Ğ¾Ğ¼Ğ°  baxroma 
furious 		Ğ±ĞµÑˆĞµĞ½Ñ‹Ğ¹  beshenÄ—iy <<
future 		Ğ±ÑƒĞ´ÑƒÑ‰Ğ¸Ğ¹  buduschiy âœ“ ;) <<!?
gain 		Ğ±Ğ°Ñ€Ñ‹Ñˆ  barÄ—ish bereich[ern]!! DE <3 <<<
gaol 		Ñ‚ÑÑ€ÑŒĞ¼Ğ°  turma âœ“
gap 		Ğ±Ñ€ĞµÑˆÑŒ  bresh[ung] âœ“

garden 		ÑĞ°Ğ´  sad  âœ“  ÑĞ°Ğ´in: green gardin!! <<< vs >>> guard ROOT!?!

gasolene 		Ğ±ĞµĞ½Ğ·Ğ¸Ğ½  benÅ›in  âœ“
gasoline 		Ğ±ĞµĞ½Ğ·Ğ¸Ğ½  benÅ›in  âœ“
gather 		ÑĞ¾Ğ±Ğ¸Ñ€Ğ°Ñ‚ÑŒ ÑĞ¾Ğ±Ñ€Ğ°Ñ‚ÑŒ  sobirat sobrat ÑĞ¾Ğ±Ğ¸Ñ€~gather
gazette 		Ğ³Ğ°Ğ·ĞµÑ‚Ğ°  gaÅ›eta  âœ“
get 		Ğ¿Ñ€Ğ¸Ğ±Ñ‹Ñ‚ÑŒ Ğ¿Ñ€Ğ¸Ğ±Ñ‹Ğ²Ğ°Ñ‚ÑŒ  pribÄ—it pribÄ—ivat pro-bet âˆš~ bÄ—it:grow
get off 		ÑĞ¿ÑƒÑĞºĞ°Ñ‚ÑŒÑÑ ÑĞ¿ÑƒÑÑ‚Ğ¸Ñ‚ÑŒÑÑ  spuskatsia spustitsia 
girder 		Ğ±Ğ°Ğ»ĞºĞ° Ğ±Ñ€ĞµĞ²Ğ½Ğ¾ Ğ±Ñ€ÑƒÑ  balka brevno brus ?
girl 		Ğ´ĞµĞ²ÑƒÑˆĞºĞ°  devushka  de-bursche?  â€-ÑƒÑˆĞºĞ° -uÅ¡ka:minUscule! klein
girl 		Ğ´ĞµĞ²ÑƒÑˆĞºĞ° ğ“ğ“ ğŒ³ğŒ°ğŒ³ğŒ³ğŒ¾ğŒ°ğŒ½ daddjan â€œsuckleâ€ ğ’‹¼ğ’‚Šğ’‹«ğ’€­ teetaan à¤§à¤¯à¤¤à¤¿ dhÃ¡yati  Õ¤Õ«Õ¥Õ´ diem
give 		Ğ´Ğ°Ğ²Ğ°Ñ‚ÑŒ Ğ´Ğ°Ñ‚ÑŒ  davat dat  âœ“
gloss 		Ğ±Ğ»ĞµÑĞº  blesk  âœ“
go 		Ğ¸Ğ´Ñ‚Ğ¸ Ğ¿Ğ¾Ğ¹Ñ‚Ğ¸ ĞµÑ…Ğ°Ñ‚ÑŒ Ğ¿Ğ¾ĞµÑ…Ğ°Ñ‚ÑŒ  poyti poexat exat idtiâ„¢  podi,ex-audit  âœ“
goal 		Ñ†ĞµĞ»ÑŒ  ssel  ~~âœ“
god 		Ğ±Ğ¾Ğ³ Ğ±Ğ¾Ğ¶ĞµÑÑ‚Ğ²Ğ¾  bog boÎ¶eestvo BIG bigga âœ“ @Persia
gold 		Ğ·Ğ¾Ğ»Ğ¾Ñ‚Ğ¾Ğ¹  Å›olotoy gholode âœ“
golden 		Ğ·Ğ¾Ğ»Ğ¾Ñ‚Ğ¾Ğ¹  Å›olotoy gholode âœ“
good 		Ñ…Ğ¾Ñ€Ğ¾ÑˆĞ¸Ğ¹  xoroshiy <<
gossip 		Ğ±Ğ°Ğ±ÑŒĞ¸ ÑĞºĞ°Ğ·ĞºĞ¸  babi skaÅ›ki 
government 		Ğ¿Ñ€Ğ°Ğ²Ğ¸Ñ‚ĞµĞ»ÑŒÑÑ‚Ğ²Ğ¾  pravitelstvo 1. PROvtoâ€¦  2. pRight! Ğ¿Ñ€Ğ°ÌĞ²Ñ‹Ğ¹ â€¢ (prÃ¡vyj) right hand
go down 		ÑĞ¿ÑƒÑĞºĞ°Ñ‚ÑŒÑÑ ÑĞ¿ÑƒÑÑ‚Ğ¸Ñ‚ÑŒÑÑ  spuskatsia spustitsia --
go for a walk 		Ğ³ÑƒĞ»ÑÑ‚ÑŒ Ğ¿Ğ¾Ğ³ÑƒĞ»ÑÑ‚ÑŒ  guliat poguliat --
go in 		Ğ²Ñ…Ğ¾Ğ´Ğ¸Ñ‚ÑŒ Ğ²Ğ¾Ğ¹Ñ‚Ğ¸  vxodit voyti â€¦audit <<
go up 		Ğ¿Ğ¾Ğ´Ğ½Ğ¸Ğ¼Ğ°Ñ‚ÑŒÑÑ Ğ¿Ğ¾Ğ´Ğ½ÑÑ‚ÑŒÑÑ  podnimatsia podniatsia âˆšpod   âœ“
gram 		Ğ³Ñ€Ğ°Ğ¼Ğ¼  gramm  âœ“
grammar 		Ğ³Ñ€Ğ°Ğ¼Ğ¼Ğ°Ñ‚Ğ¸ĞºĞ°  grammatika  âœ“
gramme 		Ğ³Ñ€Ğ°Ğ¼Ğ¼  gramm  âœ“
grandmother 		Ğ±Ğ°Ğ±ÑƒÑˆĞºĞ°  babushka/mamushka  âœ“
gratitude 		Ğ±Ğ»Ğ°Ğ³Ğ¾Ğ´Ğ°Ñ€Ğ½Ğ¾ÑÑ‚ÑŒ  blagodarnost 
greedy 		Ğ°Ğ»Ñ‡Ğ½Ñ‹Ğ¹  alchnÄ—iy Al.Knauser? alÌ‚kans â€œgreedy, hungryâ€ sober
greyhound 		Ğ±Ğ¾Ñ€Ğ·Ğ°Ñ  borÅ›aia 
great 		Ğ±Ğ¾Ğ»ÑŒÑˆĞ¾Ğ¹  bolshoy !! bolshevik <<< poly
grow 		Ğ±Ñ‹Ñ‚Ğ¾Ğ²Ğ°Ñ‚ÑŒ  bÄ—itovat beith:baut <> Ğ²Ñ‹ÑĞ¾Ñ‚Ğ° <<
gulf 		Ğ±ĞµĞ·Ğ´Ğ½Ğ°  Ğ±ĞµÅ›-dÃ¼na Bucht? abyss *dÊ°ubno:deep +- âœ“
gunner 		Ğ°Ñ€Ñ‚Ğ¸Ğ»Ğ»ĞµÑ€Ğ¸ÑÑ‚  artillerist  âœ“
half 		Ğ¿Ğ¾Ğ»Ğ¾Ğ²Ğ¸Ğ½Ğ°  polovina <<
hall 		Ğ·Ğ°Ğ»  Å›al  âœ“
ham 		Ğ²ĞµÑ‚Ñ‡Ğ¸Ğ½Ğ°  vetchina ~flesh:basar? 
hand 		Ñ€Ğ°Ğ±Ğ¾Ñ‡Ğ¸Ğ¹  rabochiy  !!!!<<<<
handsome 		ĞºÑ€Ğ°ÑĞ¸Ğ²Ñ‹Ğ¹  krasivÄ—iy 
happen 		Ğ±Ñ‹Ñ‚Ğ¾Ğ²Ğ°Ñ‚ÑŒ  bÄ—itovat 
harp 		Ğ°Ñ€Ñ„Ğ°  'arpha âœ“
harsh 		Ğ°Ğ»ÑĞ¿Ğ¾Ğ²Ğ°Ñ‚Ñ‹Ğ¹  aliapovatÄ—iy 
hat 		ÑˆĞ»ÑĞ¿Ğ°  shliapa Schlapphut <3 âœ“?
have 		Ğ¿Ğ¾Ğ»ÑƒÑ‡Ğ°Ñ‚ÑŒ Ğ¿Ğ¾Ğ»ÑƒÑ‡Ğ¸Ñ‚ÑŒ  poluchat poluchit 
have to 		Ğ´Ğ¾Ğ»Ğ¶ĞµĞ½  dolÎ¶een ~dois <<<
he 		Ğ¾Ğ½  on  âœ“
health 		Ğ·Ğ´Ğ¾Ñ€Ğ¾Ğ²Ñ‹Ğµ  Å›dorovÄ—ie << Esther/sante? â™€/ğ“‹¹
heaven 		Ğ½ĞµĞ±Ğ¾  nebo !! ğ“‹Nobel-Nebel-Narbe-Nepumuk? @SUMER <<<
heavy 		Ñ‚ÑĞ¶Ñ‘Ğ»Ñ‹Ğ¹  tiaÎ¶eÑ‘lÄ—iy <<<
height 		Ğ²Ñ‹ÑĞ¾Ñ‚Ğ°  vÄ—isota â„¢â„¢ <<< <> Ğ±ÑƒĞ³Ğ¾Ñ€:berg?
hell 		Ğ°Ğ´  ad --
helpless 		Ğ±ĞµĞ·Ğ·Ğ°Ñ‰Ğ¸Ñ‚Ğ½Ñ‹Ğ¹ Ğ±ĞµÑĞ¿Ğ¾Ğ¼Ğ¾Ñ‰Ğ½Ñ‹Ğ¹  Ğ±ĞµÅ›-Å›a.schitnÄ—iy bes.pomoschnÄ—iy 
her 		Ğ¾Ğ½Ğ°  ona  âœ“
here are 		Ğ²Ğ¾Ñ‚  vot voisi!âœ“ what 
here is 		Ğ²Ğ¾Ñ‚  vot voisi!âœ“ what
high 		Ğ²Ñ‹ÑĞ¾ĞºĞ¸Ğ¹  vÄ—isokiy â„¢ <<<
hill 		Ğ±ÑƒĞ³Ğ¾Ñ€  bugor ~ Berg!
him 		Ğ¾Ğ½  on  âœ“
hip 		Ğ±ĞµĞ´Ñ€Ğ¾  bedro @bed;) ///
hippo 		Ğ±ĞµĞ³ĞµĞ¼Ğ¾Ñ‚  begemot  !! ~âœ“
hippopotamus 		Ğ±ĞµĞ³ĞµĞ¼Ğ¾Ñ‚  begemot !! ~âœ“ 
hire 		Ğ°Ñ€ĞµĞ½Ğ´Ğ°  arenda @agenda? <<
history 		Ğ¸ÑÑ‚Ğ¾Ñ€Ğ¸Ñ  (h)istoriia  âœ“
hit 		Ğ±Ğ¸Ñ‚ÑŒ ÑƒĞ´Ğ°Ñ€Ğ¸Ñ‚ÑŒ  bit udarit âˆšbat  Ğ´Ñ€Ğ°Ñ‚ÑŒ dratÊ¹ ~ trete
holiday 		Ğ¿Ñ€Ğ°Ğ·Ğ´Ğ½Ğ¸Ğº  praÅ›dnik âˆšfree?
home 		Ğ´Ğ¾Ğ¼Ğ¾Ğ¹  domoy  âœ“
hope 		Ğ½Ğ°Ğ´ĞµÑÑ‚ÑŒÑÑ  nadeiatsia Nadia <3 â„¢
horse 		ĞºĞ¾Ğ½ÑŒ Ğ»Ğ¾ÑˆĞ°Ğ´ÑŒ  kon / loshad ~knightâœ“ âˆšlaÅ¡a â€œhorseâ€@Turk ??? lash-a? lasso? <<<
hospital 		Ğ±Ğ¾Ğ»ÑŒĞ½Ğ¸Ñ†Ğ°  bolnissa polonaise:bol=foul <<>>
hot 		Ğ³Ğ¾Ñ€ÑÑ‡Ğ¸Ğ¹  goriachiy â‰ gor << (vulkan?)
hotel 		Ğ³Ğ¾ÑÑ‚Ğ¸Ğ½Ğ¸Ñ†Ğ°  gostinissa Gastâ€¦ness? âœ“
house 		Ğ´Ğ¾Ğ¼  dom  âœ“
how 		ĞºĞ°Ğº  kak  âœ“ que.que
human being 		Ñ‡ĞµĞ»Ğ¾Ğ²ĞµĞº  chelovek <<<< MAN
hundred 		ÑÑ‚Ğ¾  sto cento ~
iceberg 		Ğ°Ğ¹ÑĞ±ĞµÑ€Ğ³  aysberg  âœ“
if 		ĞµÑĞ»Ğ¸  esli asâ€¦likeâ€¦else;) <<
illiterate 		Ğ±ĞµĞ·Ğ³Ñ€Ğ°Ğ¼Ğ¾Ñ‚Ğ½Ñ‹Ğ¹  Ğ±ĞµÅ›-gramotnÄ—iy âœ“ GR desÂ¬grammatic
ill 		Ğ±Ğ¾Ğ»ÑŒĞ½Ğ¾Ğ¹  bolnoy 
illness 		Ğ±Ğ¾Ğ»ĞµĞ·Ğ½ÑŒ  boleÅ›n @poles? <<
image 		ĞºĞ°Ñ€Ñ‚Ğ¸Ğ½Ğ°  kartina <> karta ~ âœ“
impartial 		Ğ±ĞµÑĞ¿Ğ°Ñ€Ñ‚Ğ¸Ğ¹Ğ½Ñ‹Ğ¹ Ğ±ĞµÑĞ¿Ñ€Ğ¸ÑÑ‚Ñ€Ğ°ÑÑ‚Ğ½Ñ‹Ğ¹  bespartiynÄ—iy bespristrastnÄ—iy 
important 		Ğ²Ğ°Ğ¶Ğ½Ñ‹Ğ¹  vaÎ¶enÄ—iy big>vage,vachement,vhuge? <<<
in 		Ğ² Ğ½Ğ°  vna (by)inner
incendiary bomb 		Ğ·Ğ°Ğ¶Ğ¸Ğ³Ğ°Ñ‚ĞµĞ»ÑŒĞ½Ğ°Ñ Ğ±Ğ¾Ğ¼Ğ±Ğ°  Å›aÎ¶eigatelnaia bomba 
incidental 		Ğ±Ğ¾ĞºĞ¾Ğ²Ğ¾Ğ¹  bokovoy 
inexpensive 		Ğ´ĞµÑˆÑ‘Ğ²Ñ‹Ğ¹  deshÑ‘vÄ—iy desÂ¬___
infant 		Ñ€ĞµĞ±Ñ‘Ğ½Ğ¾Ğº  rebÑ‘nok <<< RehBen?
infernal 		Ğ°Ğ´ÑĞºĞ¸Ğ¹  adskiy @sky? <
inquiry 		Ğ°Ğ½ĞºĞµÑ‚Ğ°  anketta  âœ“?
insane 		Ğ±ĞµĞ·ÑƒĞ¼Ğ½Ñ‹Ğ¹  Ğ±ĞµÅ›-umnÄ—iy 
insanity 		Ğ±ĞµĞ·ÑƒĞ¼ÑÑ‚Ğ²Ğ¾  Ğ±ĞµÅ›-umstvo 
inside 		Ğ² Ğ½Ğ°  v na by.ina
insist 		Ğ½Ğ°ÑÑ‚Ğ°Ğ¸Ğ²Ğ°Ñ‚ÑŒ Ğ½Ğ°ÑÑ‚Ğ¾ÑÑ‚ÑŒ  nastaivat nastoiat ~~ insta'ist
instructor 		ÑƒÑ‡Ğ¸Ñ‚ĞµĞ»ÑŒ  uchitel uÄÃ­tÊ¹er ~ teacher <>  iaukint exercise ğŒ±ğŒ¹ğŒ¿ğŒ·ğ„ğƒ biÅ«hts used-to
intelligent 		ÑƒĞ¼Ğ½Ñ‹Ğ¹  umnÄ—iy â„¢ <<< > des'umn
intercessor 		Ğ°Ğ´Ğ²Ğ¾ĞºĞ°Ñ‚  advokat  âœ“
interest 		Ğ¸Ğ½Ñ‚ĞµÑ€ĞµÑ  interes  âœ“
interesting 		Ğ¸Ğ½Ñ‚ĞµÑ€ĞµÑĞ½Ñ‹Ğ¹  interesnÄ—iy  âœ“
into 		Ğ² Ğ½Ğ°  v na by.nach << ~ âœ“
investigation 		Ğ°Ğ½ĞºĞµÑ‚Ğ°  anketta !!  âœ“?
in English 		Ğ¿Ğ¾â€Ğ°Ğ½Ğ³Ğ»Ğ¸Ğ¹ÑĞºĞ¸  poâ€angliyski  âœ“
in action 		Ğ°ĞºÑ‚Ğ¸Ğ²Ğ½Ñ‹Ğ¹  aktivnÄ—iy  âœ“
in a way 		Ğ±ÑƒĞ´Ñ‚Ğ¾  budto ?
in exchange for 		Ğ¿Ñ€Ğ¾Ñ‚Ğ¸Ğ²  protiv << tit.pro.tiv
in the evening 		Ğ²ĞµÑ‡ĞµÑ€Ğ¾Ğ¼  vecherom vesper<< ~âœ“
in what way 		ĞºĞ°Ğº  kak queâ€¦ ~ âœ“
it 		Ğ¾Ğ½Ğ¾  ono 1 <<
jail 		Ñ‚ÑÑ€ÑŒĞ¼Ğ°  Turma  âœ“
jester 		Ğ°Ñ€Ğ»ĞµĞºĞ¸Ğ½  (h)arlekin  âœ“
job 		Ñ€Ğ°Ğ±Ğ¾Ñ‚Ğ°  rabota  âœ“
journal 		Ğ³Ğ°Ğ·ĞµÑ‚Ğ°  gaÅ›eta  âœ“
journey 		Ğ¿ÑƒÑ‚ĞµÑˆĞµÑÑ‚Ğ²Ğ¸Ğµ  puteshestvie pode.ÑˆĞµÑÑ‚.vie <<
judge 		ÑÑƒĞ´ÑŒÑ  sudia  âœ“
jug 		Ğ±Ğ°Ğº  bak  âœ“
jump 		Ğ¿Ñ€Ñ‹Ğ³Ğ°Ñ‚ÑŒ Ğ¿Ñ€Ñ‹Ğ³Ğ½ÑƒÑ‚ÑŒ  prÄ—igat prÄ—ignut 
just 		Ñ‚Ğ¾Ğ»ÑŒĞºĞ¾  tolko tell? <
keeper of the records 		Ğ°Ñ€Ñ…Ğ¸Ğ²Ğ°Ñ€Ğ¸ÑƒÑ  archivarius âœ“
kill 		ÑƒĞ±Ğ¸Ğ²Ğ°Ñ‚ÑŒ ÑƒĞ±Ğ¸Ñ‚ÑŒ  ubivat ubit orbit! âœ“ <<
kilo 		ĞºĞ¸Ğ»Ğ¾Ğ³Ñ€Ğ°Ğ¼Ğ¼  kilogramm âœ“
kilometre 		ĞºĞ¸Ğ»Ğ¾Ğ¼ĞµÑ‚Ñ€  kilometr  âœ“
kitchen 		ĞºÑƒÑ…Ğ½Ñ  kÃ¼chnia âœ“
knee 		ĞºĞ¾Ğ»ĞµĞ½Ğ¾  koleno Kehle âœ“ kelis@Baltic
knife 		Ğ½Ğ¾Ğ¶  noÎ¶e  âœ“
know 		Ğ·Ğ½Ğ°Ñ‚ÑŒ  Å›nat  gnat,gnost ~ âœ“
know how 		Ğ·Ğ½Ğ°Ñ‚ÑŒ  Å›nat gnat,gnost ~ âœ“
laborer 		Ñ€Ğ°Ğ±Ğ¾Ñ‡Ğ¸Ğ¹  rabochiy  âœ“
labourer 		Ñ€Ğ°Ğ±Ğ¾Ñ‡Ğ¸Ğ¹  rabochiy  âœ“
lake 		Ğ¾Ğ·ĞµÑ€Ğ¾  oÅ›ero Wassereau ~ âœ“
lament 		Ğ°Ñ…Ğ°Ñ‚ÑŒ  axat  âœ“

lamb 		Ğ°Ğ³Ğ½ĞµÑ†  agness <3 <<GR

lampâ€shade 		Ğ°Ğ±Ğ°Ğ¶ÑƒÑ€  abaÎ¶eur <
lamp 		Ğ»Ğ°Ğ¼Ğ¿Ğ°  lampa  âœ“
land 		ÑÑ‚Ñ€Ğ°Ğ½Ğ°  strana strand;)  âœ“?
language 		ÑĞ·Ñ‹Ğº  iaÅ›Ä—ik sayque? <<
large 		Ğ±Ğ¾Ğ»ÑŒÑˆĞ¾Ğ¹  bolshoy ~bausch ~polis? âœ“?
lass 		Ğ´ĞµĞ²ÑƒÑˆĞºĞ°  devushka ?
lasso 		Ğ°Ñ€ĞºĞ°Ğ½  arkan ~âœ“ ğ“¯
late 		Ğ¿Ğ¾Ğ·Ğ´Ğ½Ğ¾  poÅ›dno past âœ“
lawyer 		Ğ°Ğ´Ğ²Ğ¾ĞºĞ°Ñ‚  advokat âœ“
lay a distress upon 		Ğ½Ğ°Ğ»Ğ¾Ğ¶Ğ¸Ñ‚ÑŒ Ğ°Ñ€ĞµÑÑ‚ Ğ½Ğ°  naloÎ¶eit arest na ?
lay down 		ÑÑ‚Ğ°Ğ²Ğ¸Ñ‚ÑŒ Ğ¿Ğ¾ÑÑ‚Ğ°Ğ²Ğ¸Ñ‚ÑŒ  stavit postavit ~stand-post
lay hold of 		Ğ±Ñ€Ğ°Ñ‚ÑŒ Ğ²Ğ·ÑÑ‚ÑŒ  brat vÅ›iat 
leader 		ĞºĞ°Ğ¿Ğ¸Ñ‚Ğ°Ğ½  kapitan  âœ“
leaf 		Ğ»Ğ¸ÑÑ‚  list  <<!
leap 		Ğ¿Ñ€Ñ‹Ğ³Ğ°Ñ‚ÑŒ Ğ¿Ñ€Ñ‹Ğ³Ğ½ÑƒÑ‚ÑŒ  prÄ—igat prÄ—ignut ??<< â‰ pregnant
lease 		Ğ°Ñ€ĞµĞ½Ğ´Ğ¾Ğ²Ğ°Ñ‚ÑŒ ÑĞ½Ğ¸Ğ¼Ğ°Ñ‚ÑŒ Ğ² Ğ°Ñ€ĞµĞ½Ğ´Ñƒ  arendovat snimat v arendu 
leasurely 		Ğ¼ĞµĞ´Ğ»ĞµĞ½Ğ½Ğ¾  medlenno ?
lesson 		ÑƒÑ€Ğ¾Ğº  urok <<
let 		Ğ¿ÑƒÑĞºĞ°Ñ‚ÑŒ Ğ¿ÑƒÑÑ‚Ğ¸Ñ‚ÑŒ  puskat pustit postulate! post.let;)  ~âœ“?
leave 		Ğ¿ÑƒÑĞºĞ°Ñ‚ÑŒ Ğ¿ÑƒÑÑ‚Ğ¸Ñ‚ÑŒ  puskat pustit  ^^ <<
leave behind 		Ğ¾ÑÑ‚Ğ°Ğ²Ğ»ÑÑ‚ÑŒ Ğ¾ÑÑ‚Ğ°Ğ²Ğ¸Ñ‚ÑŒ  ostavliat ostavit 
letter 		Ğ¿Ğ¸ÑÑŒĞ¼Ğ¾  pismo !!
lewd 		Ğ±Ğ»ÑƒĞ´Ğ»Ğ¸Ğ²Ñ‹Ğ¹  bludlivÄ—iy ?
librarian 		Ğ±Ğ¸Ğ±Ğ»Ğ¸Ğ¾Ñ‚ĞµĞºĞ°Ñ€ÑŒ  bibliotekar  âœ“
library 		Ğ±Ğ¸Ğ±Ğ»Ğ¸Ğ¾Ñ‚ĞµĞºĞ°  biblioteka  âœ“
lie 		Ğ»ĞµĞ¶Ğ°Ñ‚ÑŒ Ğ¿Ğ¾Ğ»ĞµĞ¶Ğ°Ñ‚ÑŒ  leÎ¶eat poleÎ¶eat lieget âœ“
lie down 		Ğ»Ğ¾Ğ¶Ğ¸Ñ‚ÑŒÑÑ Ğ»ĞµÑ‡ÑŒ  loÎ¶eitsia lech  âœ“
light 		ÑĞ²ĞµÑ‚  svet  âœ“
like 		ĞºĞ°Ğº  kak  âœ“
likewise 		Ñ‚Ğ°ĞºĞ¶Ğµ Ñ‚Ğ¾Ğ¶Ğµ  takÎ¶ee toÎ¶ee : totze ha earth esche <<
like that 		Ñ‚Ğ°Ğº  tak !
lion 		Ğ»ĞµĞ²  lev  âœ“
liquidate 		ÑƒĞ±Ğ¸Ğ²Ğ°Ñ‚ÑŒ ÑƒĞ±Ğ¸Ñ‚ÑŒ  ubivat ubit 
listen 		ÑĞ»ÑƒÑˆĞ°Ñ‚ÑŒ Ğ¿Ğ¾ÑĞ»ÑƒÑˆĞ°Ñ‚ÑŒ  slushat poslushat pos'listen <<< âœ“ ğŸ”?
literal 		Ğ±ÑƒĞºĞ²Ğ°Ğ»ÑŒĞ½Ñ‹Ğ¹  bukvalnÄ—iy Buchâ€¦ âœ“<
little brother 		Ğ±Ñ€Ğ°Ñ‚ĞµÑ†  bratess âœ“âœ“   Ñ†~rus!
live 		Ğ¶Ğ¸Ñ‚ÑŒ Ğ¿Ğ¾Ğ¶Ğ¸Ñ‚ÑŒ  Î¶eit poÎ¶eit Seiet:Zooit ++? <<<
location 		Ğ¼ĞµÑÑ‚Ğ¾  mesto << MA?
loch 		Ğ¾Ğ·ĞµÑ€Ğ¾  oÅ›ero ğ“¯Ã–se,lasso,Ğ°Ñ€ĞºĞ°Ğ½  arkan ~âœ“ 
lofty 		Ğ²Ñ‹ÑĞ¾ĞºĞ¸Ğ¹  vÄ—isokiy 
long 		Ğ´Ğ»Ğ¸Ğ½Ğ½Ñ‹Ğ¹  dlinnÄ—iy ~de'longue line <âœ“
look 		Ğ²Ğ¾Ñ‚  vot  âœ“ voit:voir <<
look at 		ÑĞ¼Ğ¾Ñ‚Ñ€ĞµÑ‚ÑŒ Ğ¿Ğ¾ÑĞ¼Ğ¾Ñ‚Ñ€ĞµÑ‚ÑŒ  smotret posmotret s'moygt <<<<
lorry 		Ğ³Ñ€ÑƒĞ·Ğ¾Ğ²Ğ¾Ğ¹ Ğ°Ğ²Ñ‚Ğ¾Ğ¼Ğ¾Ğ±Ğ¸Ğ»ÑŒ  gruÅ›ovoy avtomobil âœ“ 
lose 		Ñ‚ĞµÑ€ÑÑ‚ÑŒ Ğ¿Ğ¾Ñ‚ĞµÑ€ÑÑ‚ÑŒ  teriat poteriat << tear?
loud 		Ğ³Ñ€Ğ¾Ğ¼ĞºĞ¸Ğ¹  gromkiy vs Gram! <<
lounge 		Ğ·Ğ°Ğ»  Å›al  âœ“
love 		Ğ»ÑĞ±Ğ¸Ñ‚ÑŒ Ğ¿Ğ¾Ğ»ÑĞ±Ğ¸Ñ‚ÑŒ  lubit polubit 
lovely 		ĞºÑ€Ğ°ÑĞ¸Ğ²Ñ‹Ğ¹  krasivÄ—iy 
lowerâ€arm 		Ğ½Ğ¸Ğ¶Ğ½Ğ°Ñ Ñ‡Ğ°ÑÑ‚ÑŒ Ñ€ÑƒĞºĞ¸  niÎ¶enaia chast ruki 
luggage 		Ğ±Ğ°Ğ³Ğ°Ğ¶  bagaÎ¶e  âœ“
lump 		Ğ±ÑƒĞ»ĞºĞ°  bulka 
lust 		Ğ°Ğ·Ğ°Ñ€Ñ‚  aÅ›art ~lasart
lyric 		Ñ‚ĞµĞºÑÑ‚  tekst  âœ“!
lunacy 		Ğ±ĞµĞ·ÑƒĞ¼ÑÑ‚Ğ²Ğ¾  Ğ±ĞµÅ›-umstvo 
mad 		Ğ±ĞµĞ·ÑƒĞ¼Ğ½Ñ‹Ğ¹  Ğ±ĞµÅ›-umnÄ—iy omni-mind
madness 		Ğ±ĞµĞ·ÑƒĞ¼ÑÑ‚Ğ²Ğ¾  Ğ±ĞµÅ›-umstvo 
magazine 		Ğ³Ğ°Ğ·ĞµÑ‚Ğ°  gaÅ›eta  âœ“
maintain 		Ğ°Ñ€Ğ³ÑƒĞ¼ĞµĞ½Ñ‚Ğ¸Ñ€Ğ¾Ğ²Ğ°Ñ‚ÑŒ  argumentirovat ;)
majority 		Ğ±Ğ¾Ğ»ÑŒÑˆĞ¸Ğ½ÑÑ‚Ğ²Ğ¾  bolshinstvo 
major road 		Ğ±Ğ¾Ğ»ÑŒÑˆĞ°Ğº  bolshak <<
make 		Ğ´ĞµĞ»Ğ°Ñ‚ÑŒ ÑĞ´ĞµĞ»Ğ°Ñ‚ÑŒ  DELAT sdelat << delate~relate?
make an appeal to 		Ğ°Ğ¿ĞµĞ»Ğ»Ğ¸Ñ€Ğ¾Ğ²Ğ°Ñ‚ÑŒ Ğº  apellirovat k  âœ“
make a note 		Ğ·Ğ°Ğ¿Ğ¸ÑÑ‹Ğ²Ğ°Ñ‚ÑŒ Ğ·Ğ°Ğ¿Ğ¸ÑĞ°Ñ‚ÑŒ  Å›apisÄ—ivat Å›apisat âˆšsapiens <3  
man 		Ñ‡ĞµĞ»Ğ¾Ğ²ĞµĞº  chelovek <<<
manage 		Ğ°Ğ´Ğ¼Ğ¸Ğ½Ğ¸ÑÑ‚Ñ€Ğ¸Ñ€Ğ¾Ğ²Ğ°Ñ‚ÑŒ  administrirovat  âœ“
management 		Ğ°Ğ´Ğ¼Ğ¸Ğ½Ğ¸ÑÑ‚Ñ€Ğ°Ñ†Ğ¸Ñ  administrassiia  âœ“
manager 		Ğ°Ğ´Ğ¼Ğ¸Ğ½Ğ¸ÑÑ‚Ñ€Ğ°Ñ‚Ğ¾Ñ€  administrator  âœ“
map 		ĞºĞ°Ñ€Ñ‚Ğ°  karta  âœ“
march 		Ñ…Ğ¾Ğ´Ğ¸Ñ‚ÑŒ Ğ¿Ğ¾Ñ…Ğ¾Ğ´Ğ¸Ñ‚ÑŒ  xodit poxodit âˆšPOD  âœ“?
market 		Ğ±Ğ°Ğ·Ğ°Ñ€  baÅ›ar âœ“ 
marketplace 		Ğ±Ğ°Ğ·Ğ°Ñ€  baÅ›ar âœ“
marriage 		Ğ±Ñ€Ğ°Ğº  brak <> Braut? <<
marsh 		Ğ±Ğ¾Ğ»Ğ¾Ñ‚Ğ¾  boloto <<
matter 		Ğ´ĞµĞ»Ğ¾  delo << Teil?
mayor 		Ğ±ÑƒÑ€Ğ³Ğ¾Ğ¼Ğ¸ÑÑ‚Ñ€  burgomistr âœ“ DE:)
melon 		Ğ°Ñ€Ğ±ÑƒĞ·  arbuÅ› 
menu 		ĞºĞ°Ñ€Ñ‚Ğ°  karta âœ“
meteoric stone 		Ğ°ÑÑ€Ğ¾Ğ»Ğ¸Ñ‚  aairolit aero.lith++ âœ“
meteorite 		Ğ°ÑÑ€Ğ¾Ğ»Ğ¸Ñ‚  aairolit  âœ“
middleclass 		Ğ±ÑƒÑ€Ğ¶ÑƒĞ°Ğ·Ğ½Ñ‹Ğ¹  burÎ¶euaÅ›nÄ—iy :
middleclass citizen 		Ğ±ÑƒÑ€Ğ¶ÑƒĞ¹  burÎ¶euy Burgeoise:Bursche:Person<< âœ“?
midwife 		Ğ°ĞºÑƒÑˆĞµÑ€ĞºĞ°  akusherka 
military 		Ğ°Ñ€Ğ¼ĞµĞ¹ÑĞºĞ¸Ğ¹  armeyskiy âœ“
minute 		Ğ¼Ğ¸Ğ½ÑƒÑ‚Ğ°  minuta  âœ“
miserable 		Ğ±ĞµĞ´ÑÑ‚Ğ²ĞµĞ½Ğ½Ñ‹Ğ¹  bedstvennÄ—iy badest-veni;) âœ“?
mistake 		Ğ¾ÑˆĞ¸Ğ±ĞºĞ°  oshibka <<
monkey 		Ğ¾Ğ±ĞµĞ·ÑŒÑĞ½Ğ°  oĞ±ĞµÅ›-iana << ğ“‚ ğ“‚ ğ“ˆ– ğ“‚ ğ“ƒ·    ğ“‚ğ“‚bis-2
month 		Ğ¼ĞµÑÑÑ†  mesiass  âœ“!
moon 		Ğ»ÑƒĞ½Ğ°  luna  âœ“!
more 		Ğ±Ğ¾Ğ»ĞµĞµ  bolee  âœ“
morning 		ÑƒÑ‚Ñ€Ğ¾  utro <<
motorcycle 		Ğ¼Ğ¾Ñ‚Ğ¾Ñ†Ğ¸ĞºĞ»  motossikl  âœ“
motorway 		Ğ°Ğ²Ñ‚Ğ¾ÑÑ‚Ñ€Ğ°Ğ´Ğ°  avtostradha  âœ“+
motor road 		Ğ°Ğ²Ñ‚Ğ¾ÑÑ‚Ñ€Ğ°Ğ´Ğ°  avtostrada  âœ“
mountain 		Ğ³Ğ¾Ñ€Ğ°  gora  âœ“!
movie theatre 		ĞºĞ¸Ğ½Ğ¾  kino  âœ“
museum 		Ğ¼ÑƒĞ·ĞµĞ¹  muÅ›ey  âœ“
must 		Ğ´Ğ¾Ğ»Ğ¶ĞµĞ½  dolÎ¶een <<
mutiny 		Ğ±ÑƒĞ½Ñ‚  bunt  âœ“
mutton 		Ğ±Ğ°Ñ€Ğ°Ğ½Ğ¸Ğ½Ğ°  baranina ?
my 		Ğ¼Ğ¾Ñ‘ Ğ¼Ğ¾Ğ¹ Ğ¼Ğ¾Ñ  moÑ‘ moy moia  âœ“
name 		Ğ¸Ğ¼Ñ  imia Nomer!  âœ“
nameless 		Ğ±ĞµĞ·Ñ‹Ğ¼ÑĞ½Ğ½Ñ‹Ğ¹  Ğ±ĞµÅ›-Ä—imiannÄ—iy ~dĞµsÂ¬a-mnomne ~ âœ“
nasty 		Ğ¿Ğ»Ğ¾Ñ…Ğ¾Ğ¹  ploxoy 
nearly 		Ğ¿Ğ¾Ñ‡Ñ‚Ğ¸  pochti 
needle 		Ğ±ÑƒĞ»Ğ°Ğ²ĞºĞ°  bulavka <<
neither 		Ğ½Ğ¸ĞºÑ‚Ğ¾  nikto  âœ“
neither ... nor 		Ğ½Ğ¸...Ğ½Ğ¸  ni...ni  âœ“
new 		Ğ½Ğ¾Ğ²Ñ‹Ğ¹  novÄ—iy  âœ“
newspaper 		Ğ³Ğ°Ğ·ĞµÑ‚Ğ°  gaÅ›eta  âœ“
next 		Ğ±ÑƒĞ´ÑƒÑ‰Ğ¸Ğ¹  buduschiy by'dux? <<
near 		Ğ¾ĞºĞ¾Ğ»Ğ¾ Ñƒ  okolo u 
nearby 		Ğ¾ĞºĞ¾Ğ»Ğ¾ Ñƒ  okolo u 
near to 		Ğ¾ĞºĞ¾Ğ»Ğ¾ Ñƒ  okolo u 
next to 		Ğ¾ĞºĞ¾Ğ»Ğ¾ Ñƒ  au'kolo au 
nice 		Ñ…Ğ¾Ñ€Ğ¾ÑˆĞ¸Ğ¹  xoroshiy <<
nine 		Ğ´ĞµĞ²ÑÑ‚ÑŒ  deviat 
nitrogen 		Ğ°Ğ·Ğ¾Ñ‚  aÅ›ot 
no 		Ğ½ĞµÑ‚  net  âœ“
noâ€one 		Ğ½Ğ¸ĞºÑ‚Ğ¾  nikto 
nobody 		Ğ½Ğ¸ĞºÑ‚Ğ¾  nikto :
none 		Ğ½Ğ¸ĞºÑ‚Ğ¾  nikto Nichts âœ“
nonsense 		Ğ°Ğ±ÑÑƒÑ€Ğ´  absurd  âœ“
north 		ÑĞµĞ²ĞµÑ€  sever Sibir  âœ“
nose 		Ğ½Ğ¾Ñ  nos  âœ“
not 		Ğ½Ğµ  ne  âœ“
note 		Ğ±Ğ¸Ğ»ĞµÑ‚  bilet  âœ“
notebook 		Ñ‚ĞµÑ‚Ñ€Ğ°Ğ´ÑŒ  tetrad 
notice 		Ğ°Ñ„Ğ¸ÑˆĞ°  athisha  office? <<
nought 		Ğ½Ğ¾Ğ»ÑŒ  nol  âœ“
novel 		Ğ½Ğ¾Ğ²Ñ‹Ğ¹  novÄ—iy  âœ“
now 		Ñ‚ĞµĞ¿ĞµÑ€ÑŒ  teper <> HOTEP? <<
nowhere 		Ğ½Ğ¸Ğ³Ğ´Ğµ  nigde  âœ“
nuts 		Ğ±ĞµĞ·ÑƒĞ¼Ğ½Ñ‹Ğ¹  Ğ±ĞµÅ›-umnÄ—iy Â¬mind!
nutty 		Ğ°Ñ€Ğ¾Ğ¼Ğ°Ñ‚Ğ¸Ñ‡ĞµÑĞºĞ¸Ğ¹ Ğ°Ñ€Ğ¾Ğ¼Ğ°Ñ‚Ğ¸Ñ‡Ğ½Ñ‹Ğ¹  aromaticheskiy aromatichnÄ—iy 
object 		Ğ²ĞµÑ‰ÑŒ  vesch 
obstetrician 		Ğ°ĞºÑƒÑˆĞµÑ€ĞºĞ° Ğ°ĞºÑƒÑˆĞµÑ€  akusherka akusher 
occur 		Ğ±Ñ‹Ñ‚Ğ¾Ğ²Ğ°Ñ‚ÑŒ  bÄ—itovat 
of a battle 		Ğ±Ğ¾ĞµĞ²Ğ¾Ğ¹  boevoy 
of a beaver 		Ğ±Ğ¾Ğ±Ñ€Ğ¾Ğ²Ñ‹Ğ¹  bobrovÄ—iy BieberovÄ—iy + âœ“
of the coast 		Ğ±ĞµÑ€ĞµĞ³Ğ¾Ğ²Ğ¾Ğ¹  beregovoy ^Berg
okay 		Ñ…Ğ¾Ñ€Ğ¾ÑˆĞ¸Ğ¹  xoroshiy klaro.shÃ¬:æ˜¯ ?
old 		ÑÑ‚Ğ°Ñ€Ñ‹Ğ¹  starÄ—iy ğ“‡½ <>sterben senior
omnibus 		Ğ°Ğ²Ñ‚Ğ¾Ğ±ÑƒÑ  avtobus  âœ“
on 		Ğ² Ğ½Ğ°  v na 
once more 		Ğ¾Ğ¿ÑÑ‚ÑŒ  opiat 
one 		ĞºÑ‚Ğ¾â€Ñ‚Ğ¾  ktoâ€to 
onerous 		Ñ‚ÑĞ¶Ñ‘Ğ»Ñ‹Ğ¹  tiaÎ¶eÑ‘lÄ—iy 
one hundred 		ÑÑ‚Ğ¾  sto 
only 		Ñ‚Ğ¾Ğ»ÑŒĞºĞ¾  tolko 
on account of 		Ğ¸Ğ·â€Ğ·Ğ°  iÅ›â€Å›a 
on the other side of 		Ğ¿Ğ¾Ğ¿ĞµÑ€Ñ‘Ğº  poperÑ‘k 
on time 		Ğ°ĞºĞºÑƒÑ€Ğ°Ñ‚Ğ½Ñ‹Ğ¹  akkuratnÄ—iy 
on top 		Ğ½Ğ°Ğ²ĞµÑ€Ñ…Ñƒ  naverxu 
open 		Ğ¾Ñ‚ĞºÑ€Ñ‹Ğ²Ğ°Ñ‚ÑŒ Ğ¾Ñ‚ĞºÑ€Ñ‹Ñ‚ÑŒ  otkrÄ—ivat otkrÄ—it 
open up 		Ğ¾Ñ‚ĞºÑ€Ñ‹Ğ²Ğ°Ñ‚ÑŒ Ğ¾Ñ‚ĞºÑ€Ñ‹Ñ‚ÑŒ  otkrÄ—ivat otkrÄ—it 
operative 		Ñ€Ğ°Ğ±Ğ¾Ñ‡Ğ¸Ğ¹  rabochiy 
opposed to 		Ğ¿Ñ€Ğ¾Ñ‚Ğ¸Ğ²  protiv 
opposite 		Ğ¿Ñ€Ğ¾Ñ‚Ğ¸Ğ²  protiv  âœ“
orange 		Ğ°Ğ¿ĞµĞ»ÑŒÑĞ¸Ğ½  apelsin 
order 		Ğ¿Ñ€Ğ¸ĞºĞ°Ğ·Ñ‹Ğ²Ğ°Ñ‚ÑŒ Ğ¿Ñ€Ğ¸ĞºĞ°Ğ·Ğ°Ñ‚ÑŒ  prikaÅ›Ä—ivat prikaÅ›at 
ordinarily 		Ğ¾Ğ±Ñ‹Ñ‡Ğ½Ğ¾  obÄ—ichno 
other 		Ğ´Ñ€ÑƒĞ³Ğ¾Ğ¹  drugoy 
ought to 		Ğ´Ğ¾Ğ»Ğ¶ĞµĞ½  dolÎ¶een 
outline 		Ğ°Ğ±Ñ€Ğ¸Ñ  abris 
over 		Ğ½Ğ°Ğ´  nad 
overhead 		Ğ½Ğ°Ğ²ĞµÑ€Ñ…Ñƒ  naverxu 
over there 		Ñ‚Ğ°Ğ¼  tam 
owing to 		Ğ¸Ğ·â€Ğ·Ğ°  iÅ›â€Å›a 
own 		ÑĞ¾Ğ±ÑÑ‚Ğ²ĞµĞ½Ğ½Ñ‹Ğ¹  sobstvennÄ—iy 
page 		ÑÑ‚Ñ€Ğ°Ğ½Ğ¸Ñ†Ğ°  stranissa 
pain 		Ğ±Ğ¾Ğ»ÑŒ  bol 
painful 		Ğ±Ğ¾Ğ»ĞµĞ·Ğ½ĞµĞ½Ğ½Ñ‹Ğ¹  boleÅ›nennÄ—iy 
painting 		ĞºĞ°Ñ€Ñ‚Ğ¸Ğ½Ğ°  kartina  âœ“
pale 		Ğ±Ğ»ĞµĞ´Ğ½Ñ‹Ğ¹  blednÄ—iy 
pancake 		Ğ±Ğ»Ğ¸Ğ½  blin 
pants 		Ğ±Ñ€ÑĞºĞ¸  bruki 
paper 		Ğ±ÑƒĞ¼Ğ°Ğ³Ğ°  bumaga 
paragraph 		Ğ°Ğ±Ğ·Ğ°Ñ†  abÅ›ass 
pardon 		Ğ¾Ğ±ÑŠÑĞ²Ğ¸Ñ‚ÑŒ Ğ°Ğ¼Ğ½Ğ¸ÑÑ‚Ğ¸Ñ  obhiavit amnistiÑ 
parings 		Ğ±Ñ€Ğ°Ğº  brak 
parliament 		Ğ¿Ğ°Ñ€Ğ»Ğ°Ğ¼ĞµĞ½Ñ‚  parlament  âœ“
parlour 		Ğ·Ğ°Ğ»  Å›al 
passion 		Ğ°Ğ·Ğ°Ñ€Ñ‚  aÅ›art 
passionate 		Ğ°Ğ·Ğ°Ñ€Ñ‚Ğ½Ñ‹Ğ¹  aÅ›artnÄ—iy 
pastor 		Ğ±Ğ°Ñ‚ÑÑˆĞºĞ°  batÑshka 
patient 		Ğ±Ğ¾Ğ»ÑŒĞ½Ğ¾Ğ¹  bolnoy 
pawn 		ÑĞ¾Ğ»Ğ´Ğ°Ñ‚  soldat 
pay 		Ğ¿Ğ»Ğ°Ñ‚Ğ¸Ñ‚ÑŒ Ğ·Ğ°Ğ¿Ğ»Ğ°Ñ‚Ğ¸Ñ‚ÑŒ  platit Å›aplatit 
peanut 		Ğ°Ñ€Ğ°Ñ…Ğ¸Ñ  araxis 
pencil 		ĞºĞ°Ñ€Ğ°Ğ½Ğ´Ğ°Ñˆ  karandash 
per 		Ğ² Ğ½Ğ°  v na 
perform 		Ğ²Ñ…Ğ¾Ğ´Ğ¸Ñ‚ÑŒ Ğ²Ğ¾Ğ¹Ñ‚Ğ¸  vxodit voyti 
periodical 		Ğ³Ğ°Ğ·ĞµÑ‚Ğ°  gaÅ›eta 
persist 		Ğ°Ñ€Ñ‚Ğ°Ñ‡Ğ¸Ñ‚ÑŒÑÑ  artachitsia 
personal 		ÑĞ¾Ğ±ÑÑ‚Ğ²ĞµĞ½Ğ½Ñ‹Ğ¹  sobstvennÄ—iy 
petrol 		Ğ±ĞµĞ½Ğ·Ğ¸Ğ½  benÅ›in 
physician 		Ğ²Ñ€Ğ°Ñ‡ Ğ´Ğ¾ĞºÑ‚Ğ¾Ñ€  vrach doktor 
physicist 		Ñ„Ğ¸Ğ·Ğ¸Ğº  PhiÅ›ik 
pick out 		Ğ²Ñ‹Ğ±Ğ¸Ñ€Ğ°Ñ‚ÑŒ Ğ²Ñ‹Ğ±Ñ€Ğ°Ñ‚ÑŒ  vÄ—ibirat vÄ—ibrat 
pick up 		ÑĞ¾Ğ±Ğ¸Ñ€Ğ°Ñ‚ÑŒ ÑĞ¾Ğ±Ñ€Ğ°Ñ‚ÑŒ  sobirat sobrat 
picture 		ĞºĞ°Ñ€Ñ‚Ğ¸Ğ½Ğ°  kartina 
pilgrim 		Ğ±Ğ¾Ğ³Ğ¾Ğ¼Ğ¾Ğ»ĞµÑ†  bogomoless 
pilgrimage 		Ğ±Ğ¾Ğ³Ğ¾Ğ¼Ğ¾Ğ»ÑŒĞµ  bogomole 
pin 		Ğ±ÑƒĞ»Ğ°Ğ²ĞºĞ°  bulavka 
pineapple 		Ğ°Ğ½Ğ°Ğ½Ğ°Ñ  ananas 
pious 		Ğ±Ğ»Ğ°Ğ³Ğ¾Ñ‡ĞµÑÑ‚Ğ¸Ğ²Ñ‹Ğ¹ Ğ±Ğ¾Ğ³Ğ¾Ğ±Ğ¾ÑĞ·Ğ½ĞµĞ½Ğ½Ñ‹Ğ¹  blagochestivÄ—iy bogoboiaÅ›nennÄ—iy 
placard 		Ğ°Ñ„Ğ¸ÑˆĞ°  athisha  p/t? <<
place 		Ğ¼ĞµÑÑ‚Ğ¾  mesto 
plain 		ÑÑ€ĞºĞ¸Ğ¹  iarkiy 
plan 		Ğ¿Ğ»Ğ°Ğ½  plan  âœ“
plane 		Ğ°ÑÑ€Ğ¾Ğ¿Ğ»Ğ°Ğ½ ÑĞ°Ğ¼Ğ¾Ğ»Ñ‘Ñ‚  aairoplan samolÑ‘t 
plate 		Ğ±Ğ»ÑĞ´Ğ¾  bludo  âœ“
platter 		Ğ±Ğ»ÑĞ´Ğ¾  bludo 
play 		Ğ¸Ğ³Ñ€Ğ°Ñ‚ÑŒ ÑÑ‹Ğ³Ñ€Ğ°Ñ‚ÑŒ  igrat sÄ—igrat 
plea 		Ğ°Ñ€Ğ³ÑƒĞ¼ĞµĞ½Ñ‚  argument 
please 		Ğ¿Ğ¾Ğ¶Ğ°Ğ»ÑƒĞ¹ÑÑ‚Ğ°  poÎ¶ealuysta 
pleased 		Ğ´Ğ¾Ğ²Ğ¾Ğ»ÑŒĞ½Ñ‹Ğ¹  dovolnÄ—iy 
plume 		Ğ¿ĞµÑ€Ğ¾  pero  âœ“
pole 		Ğ±Ñ€ÑƒÑĞ¾Ğº  brusok 
pool 		Ğ±Ğ°ÑÑĞµĞ¹Ğ½ Ğ´Ğ»Ñ Ğ¿Ğ»Ğ°Ğ²Ğ°Ğ½Ğ¸Ñ  basseyn dlia plavaniia 
poor 		Ğ¿Ğ»Ğ¾Ñ…Ğ¾Ğ¹  ploxoy  âœ“
popular 		Ğ¿Ğ¾Ğ¿ÑƒĞ»ÑÑ€Ğ½Ñ‹Ğ¹  populiarnÄ—iy  âœ“
pork 		Ğ±ÑƒĞ¶ĞµĞ½Ğ¸Ğ½Ğ°  buÎ¶eenina 
poster 		Ğ°Ñ„Ğ¸ÑˆĞ°  aphisha ++
poverty 		Ğ±ĞµĞ´Ğ½Ğ¾ÑÑ‚ÑŒ Ğ±ĞµĞ´Ğ½Ğ¾Ñ‚Ğ°  bednost bednota 
practice 		ÑƒĞ¿Ñ€Ğ°Ğ¶Ğ½ĞµĞ½Ğ¸Ğµ  upraÎ¶enenie 
precipice 		Ğ±ĞµĞ·Ğ´Ğ½Ğ°  Ğ±ĞµÅ›-dna 
pregnant 		Ğ±ĞµÑ€ĞµĞ¼ĞµĞ½Ğ½Ğ°Ñ  beremennaia 
presentâ€day 		Ğ°ĞºÑ‚ÑƒĞ°Ğ»ÑŒĞ½Ğ¾ÑÑ‚ÑŒ  aktualnost 
present 		Ğ°ĞºÑ‚ÑƒĞ°Ğ»ÑŒĞ½Ğ¾ÑÑ‚ÑŒ  aktualnost 
pricey 		Ğ´Ğ¾Ñ€Ğ¾Ğ³Ğ¾Ğ¹  dorogoy 
priest 		Ğ±Ğ°Ñ‚ÑÑˆĞºĞ°  batÑshka 
prison 		Ñ‚ÑÑ€ÑŒĞ¼Ğ°  turma âœ“
prisoner 		Ğ°Ñ€ĞµÑÑ‚Ğ°Ğ½Ñ‚  arestant âœ“
problem 		Ğ²Ğ¾Ğ¿Ñ€Ğ¾Ñ Ğ¿Ñ€Ğ¾Ğ±Ğ»ĞµĞ¼Ğ°  vopros problema âœ“
professor 		Ğ¿Ñ€Ğ¾Ñ„ĞµÑÑĞ¾Ñ€  professor  âœ“
profit 		Ğ±Ğ°Ñ€Ñ‹Ñˆ  barÄ—ish ~? 
project 		Ğ¿Ğ»Ğ°Ğ½  plan âœ“
prompt 		Ğ°ĞºĞºÑƒÑ€Ğ°Ñ‚Ğ½Ñ‹Ğ¹  akkuratnÄ—iy âœ“
proper 		Ğ¿Ñ€Ğ°Ğ²Ğ¸Ğ»ÑŒĞ½Ñ‹Ğ¹  praĞ²ilnÄ—iy âœ“

ranch 		Ñ„ĞµÑ€Ğ¼Ğ°  therma  perma farm terra << Ñ„ +++
property 		Ñ„ĞµÑ€Ğ¼Ğ°  therma perma farm terra << Ñ„ +++

provided that 		ĞµÑĞ»Ğ¸  esli   es ist al âœ“~

pub 		Ğ±Ğ°Ñ€  bar  âœ“
pulley 		Ğ±Ğ»Ğ¾Ğº  blok ~âœ“
punctual 		Ğ°ĞºĞºÑƒÑ€Ğ°Ñ‚Ğ½Ñ‹Ğ¹  akkuratnÄ—iy âœ“!! EG
purchase 		Ğ¿Ğ¾ĞºÑƒĞ¿Ğ°Ñ‚ÑŒ ĞºÑƒĞ¿Ğ¸Ñ‚ÑŒ  pokupat kupit Kauf âœ“ 

pure 		Ñ‡Ğ¸ÑÑ‚Ñ‹Ğ¹  chistÄ—iy  christi crystal !!! <<< !!! <<<<<< âœ“âœ“âœ“

purpose 		Ñ†ĞµĞ»ÑŒ  ssel Ziel âœ“

put 		ÑÑ‚Ğ°Ğ²Ğ¸Ñ‚ÑŒ Ğ¿Ğ¾ÑÑ‚Ğ°Ğ²Ğ¸Ñ‚ÑŒ  stavit postavit   put=post!!! âœ“âœ“âœ“ <<<
put down 		ÑÑ‚Ğ°Ğ²Ğ¸Ñ‚ÑŒ Ğ¿Ğ¾ÑÑ‚Ğ°Ğ²Ğ¸Ñ‚ÑŒ  stavit postavit !! <3 <<< ~â„¢

quite 		Ğ¾Ñ‡ĞµĞ½ÑŒ  ochen : ogen=[schw]eigen @ EG !!!<<<<

race 		Ğ±ĞµĞ³Ğ°Ñ‚ÑŒ Ğ±ĞµĞ¶Ğ°Ñ‚ÑŒ  begat beÎ¶eat wegesâ€¦ âœ“/3 <> run 

rain 		Ğ´Ğ¾Ğ¶Ğ´ÑŒ  doÎ¶ed shed ğ“¿ <<<

ram 		Ğ±Ğ°Ñ€Ğ°Ğ½  baran  âœ“ boram <<?
rapid 		Ğ±Ñ‹ÑÑ‚Ñ€Ñ‹Ğ¹  bÄ—istrÄ—iy fÄ—ist:fast ~~âœ“ <<<<<
quick 		Ğ±Ñ‹ÑÑ‚Ñ€Ñ‹Ğ¹  bÄ—istrÄ—iy fÄ—ist:fast ~~âœ“ <<<<<
quickly 		Ğ±Ñ‹ÑÑ‚Ñ€Ğ¾ ÑĞºĞ¾Ñ€Ğ¾  bÄ—istro skoro fÄ—ist:fast s'curier  ~âœ“
razor 		Ğ±Ñ€Ğ¸Ñ‚Ğ²Ğ°  britva @Bart âœ“â„¢
read 		Ñ‡Ğ¸Ñ‚Ğ°Ñ‚ÑŒ  chitat  ~ read.at âœ“??<<<
read Ğ¿Ñ€Ğ¾Ñ‡Ğ¸Ñ‚Ğ°Ñ‚ÑŒ prochitat 
realize 		Ğ¿Ğ¾Ğ½Ğ¸Ğ¼Ğ°Ñ‚ÑŒ Ğ¿Ğ¾Ğ½ÑÑ‚ÑŒ  ponimat poniat <> penser? âœ“?
rearguard 		Ğ°Ñ€ÑŒĞµÑ€Ğ³Ğ°Ñ€Ğ´  arergard  âœ“
rear 		Ğ°Ñ€ÑŒĞµÑ€Ğ³Ğ°Ñ€Ğ´  arergard âœ“ ^^! <3
rebellion 		Ğ±ÑƒĞ½Ñ‚  bunt : Wende ~~âœ“
rebel 		Ğ±ÑƒĞ½Ñ‚Ğ¾Ğ²Ğ°Ñ‚ÑŒ Ğ²Ğ·Ğ±ÑƒĞ½Ñ‚Ğ¾Ğ²Ğ°Ñ‚ÑŒÑÑ  buntovat vÅ›.buntovatsia  ^^
rebuke 		Ğ±Ñ€Ğ°ĞºĞ¾Ğ²Ğ°Ñ‚ÑŒ  brakovat 
receive 		Ğ¿Ñ€Ğ¸Ğ½Ğ¸Ğ¼Ğ°Ñ‚ÑŒ  prinimat 
recline 		Ğ»ĞµĞ¶Ğ°Ñ‚ÑŒ Ğ¿Ğ¾Ğ»ĞµĞ¶Ğ°Ñ‚ÑŒ  leÎ¶eat poleÎ¶eat 
recognize 		ÑƒĞ·Ğ½Ğ°Ğ²Ğ°Ñ‚ÑŒ ÑƒĞ·Ğ½Ğ°Ñ‚ÑŒ  uÅ›navat ut.znat  re.gnost âœ“~~
records 		Ğ°Ñ€Ñ…Ğ¸Ğ²  arxiv âœ“
red 		ĞºÑ€Ğ°ÑĞ½Ñ‹Ğ¹  krasnÄ—iy <<<

referee 		Ğ°Ñ€Ğ±Ğ¸Ñ‚Ñ€  arbitr âœ“

refuse 		Ğ±Ñ€Ğ°Ğº  brak Pfusch:Fehler/Ehe LOOL

regard 		ÑÑ‡Ğ¸Ñ‚Ğ°Ñ‚ÑŒ  schitat  schÃ¤Å›en âœ“
regrettably 		Ğº ÑĞ¾Ğ¶Ğ°Ğ»ĞµĞ½Ğ¸Ñ  k soÎ¶ealeniÑ 
regulation 		Ğ¿Ñ€Ğ°Ğ²Ğ¸Ğ»Ğ¾  pravilo 
release 		Ğ¿ÑƒÑĞºĞ°Ñ‚ÑŒ Ğ¿ÑƒÑÑ‚Ğ¸Ñ‚ÑŒ  puskat pustit 
remain 		Ğ¾ÑÑ‚Ğ°Ğ²Ğ°Ñ‚ÑŒÑÑ Ğ¾ÑÑ‚Ğ°Ñ‚ÑŒÑÑ  ostavatsia ostatsia 
rent 		Ğ°Ñ€ĞµĞ½Ğ´Ğ°  arenda  âœ“
rental 		Ğ°Ñ€ĞµĞ½Ğ´Ğ°  arenda  âœ“
renter 		Ğ°Ñ€ĞµĞ½Ğ´Ğ°Ñ‚Ğ¾Ñ€  arendator  âœ“
reply 		Ğ¾Ñ‚Ğ²ĞµÑ‡Ğ°Ñ‚ÑŒ Ğ¾Ñ‚Ğ²ĞµÑ‚Ğ¸Ñ‚ÑŒ  otvechat otvetit 
reservoir 		Ğ±Ğ°ÑÑĞµĞ¹Ğ½  bassin âœ“

resist 		Ğ°Ñ€Ñ‚Ğ°Ñ‡Ğ¸Ñ‚ÑŒÑÑ  artachitsia  (strÃ¤uben , widerseÅ›en  ) <<

respond 		Ğ¾Ñ‚Ğ²ĞµÑ‡Ğ°Ñ‚ÑŒ Ğ¾Ñ‚Ğ²ĞµÑ‚Ğ¸Ñ‚ÑŒ  otvechat otvetit aus-wiedern = erwiedern!!<< ~ aus-sprechen?

rest 		Ğ¾Ñ‚Ğ´Ñ‹Ñ…Ğ°Ñ‚ÑŒ otdÄ—ixat ausdÃ¶sen = ausruhen âœ“ ++ <3
rest 		Ğ¾Ñ‚Ğ´Ğ¾Ñ…Ğ½ÑƒÑ‚ÑŒ  otdoxnut ausdÃ¶sen = ausruhen âœ“
repose 		Ğ¾Ñ‚Ğ´Ñ‹Ñ…Ğ°Ñ‚ÑŒ Ğ¾Ñ‚Ğ´Ğ¾Ñ…Ğ½ÑƒÑ‚ÑŒ  otdÄ—ixat otdoxnut âœ“ ^^

revolt 		Ğ±ÑƒĞ½Ñ‚Ğ¾Ğ²Ğ°Ñ‚ÑŒ   buntovat <> bend:wend âœ“!! <3 <<
revolt 		Ğ²Ğ·Ğ±ÑƒĞ½Ñ‚Ğ¾Ğ²Ğ°Ñ‚ÑŒÑÑ vez.buntovatsia  ^^

rich 		Ğ±Ğ¾Ğ³Ğ°Ñ‚Ñ‹Ğ¹  bogatÄ—iy  BIG be-Gabt : ergiebig ausgiebig âœ“
rich man 		Ğ±Ğ¾Ğ³Ğ°Ñ‡  bogach / ^^ bogota;)

river 		Ñ€ĞµĞºĞ°  reka  âœ“ ReikiaWik? <<< rod@Pers 
rod 		Ğ±Ñ€ÑƒÑĞ¾Ğº  brusok ~brush <>bat?
rogue 		Ğ±ĞµÑÑ‚Ğ¸Ñ  bestiia âœ“
room 		ĞºĞ¾Ğ¼Ğ½Ğ°Ñ‚Ğ°  komnata commun.at âœ“/2
rouble 		Ñ€ÑƒĞ±Ğ»ÑŒ  rubl  âœ“

road 		Ğ´Ğ¾Ñ€Ğ¾Ğ³Ğ°  doroga   âœ“~âœ“! direction   rog~rod
route 		Ğ´Ğ¾Ñ€Ğ¾Ğ³Ğ°  do'roga âœ“~âœ“! direction 
rubbish 		Ğ°Ğ±ÑÑƒÑ€Ğ´  absurd âœ“ ! ++
ruble 		Ñ€ÑƒĞ±Ğ»ÑŒ  rubl  âœ“

right 		Ğ¿Ñ€Ğ°Ğ²Ñ‹Ğ¹  pravÄ—iy  1. first <<<+++?  private:polit,bravo,braveâ€¦ !? _____
righthand 		Ğ¿Ñ€Ğ°Ğ²Ñ‹Ğ¹  pravÄ—iy 
rule 		Ğ¿Ñ€Ğ°Ğ²Ğ¸Ğ»Ğ¾  pravilo ^^



roam 		Ğ±Ñ€Ğ¾Ğ´Ğ¸Ñ‚ÑŒ  brodit beroad<>bereisen!! ++ <<< <3 vs

run 		Ğ±ĞµĞ³Ğ°Ñ‚ÑŒ Ğ±ĞµĞ¶Ğ°Ñ‚ÑŒ  begat weg-ga-*!! beÎ¶eat âˆšpod
run away 		Ğ±ĞµĞ¶Ğ°Ñ‚ÑŒ  beÎ¶eat âˆšpod
run across 		Ğ±Ğ¸Ñ‚ÑŒ ÑƒĞ´Ğ°Ñ€Ğ¸Ñ‚ÑŒ  bit udarit âˆšpod audireâ€¦

safety 		Ğ±ĞµĞ·Ğ¾Ğ¿Ğ°ÑĞ½Ğ¾ÑÑ‚ÑŒ  Ğ±ĞµÅ›-opasnost Aufpass;) <?
safety pin 		Ğ°Ğ½Ğ³Ğ»Ğ¸Ğ¹ÑĞºĞ°Ñ Ğ±ÑƒĞ»Ğ°Ğ²ĞºĞ°  angliyskaia bulavka 
sagacious 		ÑƒĞ¼Ğ½Ñ‹Ğ¹  umnÄ—iy omni:mind
sallow 		Ğ±Ğ»ĞµĞ´Ğ½Ñ‹Ğ¹  blednÄ—iy blass~platt âœ“
salon 		Ğ·Ğ°Ğ»  Å›al  âœ“
sandbank 		Ğ±Ğ°Ğ½ĞºĞ°  banka  âœ“
satisfied 		Ğ´Ğ¾Ğ²Ğ¾Ğ»ÑŒĞ½Ñ‹Ğ¹  dovolnÄ—iy doÂ¬wollen âœ“?

saucer 		Ğ±Ğ»ÑĞ´ĞµÑ‡ĞºĞ¾ Ğ±Ğ»ÑĞ´Ñ†Ğµ  bludechko bludsse Bloedsinn;)
sausage 		ĞºĞ¾Ğ»Ğ±Ğ°ÑĞ°  kolbasat 

say 		Ğ³Ğ¾Ğ²Ğ¾Ñ€Ğ¸Ñ‚ÑŒ  govorit 'geben'? <<?
say 		ÑĞºĞ°Ğ·Ğ°Ñ‚ÑŒ skaÅ›at  chat<>kaÅ›e!! <<<!

scale 		Ğ·Ğ°Ğ±Ğ¸Ñ€Ğ°Ñ‚ÑŒÑÑ Ğ² Ğ·Ğ°Ğ±Ñ€Ğ°Ñ‚ÑŒÑÑ Ğ² Ğ·Ğ°Ğ±Ğ¸Ñ€Ğ°Ñ‚ÑŒÑÑ Ğ½Ğ° Ğ·Ğ°Ğ±Ñ€Ğ°Ñ‚ÑŒÑÑ Ğ½Ğ°  Å›abiratsia v Å›abratsia v Å›abiratsia na Å›abratsia na 
scheme 		Ğ¿Ğ»Ğ°Ğ½  plan 
school 		ÑˆĞºĞ¾Ğ»Ğ°  shkola  âœ“
screen 		Ğ·Ğ°Ğ±Ğ¸Ñ€Ğ°Ñ‚ÑŒ Ğ·Ğ°Ğ±Ñ€Ğ°Ñ‚ÑŒ  Å›abirat Å›abrat 
scuffle 		Ğ±Ğ¸Ñ‚Ğ²Ğ° Ğ±Ğ¾Ğ¹ Ğ±Ğ¾Ñ€ÑŒĞ±Ğ°  bitva boy borba 

sea 		Ğ¼Ğ¾Ñ€Ğµ  more Mare âœ“

seaside 		Ğ±ĞµÑ€ĞµĞ³  bereg ?

security 		Ğ±ĞµĞ·Ğ¾Ğ¿Ğ°ÑĞ½Ğ¾ÑÑ‚ÑŒ  Ğ±ĞµÅ›-opasnost    á¼”Î³Î³Ï….Î¿Ï‚? --?<

see 		Ğ²Ğ¸Ğ´ĞµÑ‚ÑŒ ÑƒĞ²Ğ¸Ğ´ĞµÑ‚ÑŒ  videt uvidet âœ“!

seize 		Ğ½Ğ°Ğ»Ğ¾Ğ¶Ğ¸Ñ‚ÑŒĞ°Ñ€ĞµÑÑ‚ Ğ½Ğ°  nalo.Î¶eitarest na  <<<

sell 		Ğ¿Ñ€Ğ¾Ğ´Ğ°Ğ²Ğ°Ñ‚ÑŒ Ğ¿Ñ€Ğ¾Ğ´Ğ°Ñ‚ÑŒ  prodavat prodat <<âœ“? weg-geben!

send 		Ğ¿Ğ¾ÑÑ‹Ğ»Ğ°Ñ‚ÑŒ Ğ¿Ğ¾ÑĞ»Ğ°Ñ‚ÑŒ  posÄ—ilat poslat âœ“ postilat

sentence 		Ñ„Ñ€Ğ°Ğ·Ğ°  phraÅ›a âœ“

serious 		Ğ²Ğ°Ğ¶Ğ½Ñ‹Ğ¹  vaÎ¶enÄ—iy <<<>  	bedeutend,maÅ›geblich

set 		Ğ°Ğ¿Ğ¿Ğ°Ñ€Ğ°Ñ‚  apparat âœ“
settlement 		Ğ°ÑƒĞ»  aul  "der Aul" Gau? Tal tell?

seven 		ÑĞµĞ¼ÑŒ  seÑŒm  âœ“

several times 		Ğ±Ñ‹Ğ²Ğ°Ğ»Ğ¾  bÄ—ivalo  <<<<<

share 		Ğ°ĞºÑ†Ğ¸Ñ  aktiea âœ“
shareholder 		Ğ°ĞºÑ†Ğ¸Ğ¾Ğ½ĞµÑ€  akssioner âœ“
shark 		Ğ°ĞºÑƒĞ»Ğ°  akula  aqua-haiena ~âœ“ 'dog'
shave 		Ğ±Ñ€Ğ¸Ñ‚ÑŒ  brit : Bart âœ“â„¢
she 		Ğ¾Ğ½Ğ°  ona  <<
shed 		Ğ±ÑƒĞ´ĞºĞ°  budka  Bude âœ“
sheen 		Ğ±Ğ»ĞµÑĞº  blesk  BliÅ›enâœ“  Glanz, Schein vs blass!
sheet 		Ğ»Ğ¸ÑÑ‚  list  âœ“!
shockâ€absorber 		Ğ°Ğ¼Ğ¾Ñ€Ñ‚Ğ¸Ğ·Ğ°Ñ‚Ğ¾Ñ€  amortiÅ›ator  âœ“
shoe 		Ğ±Ğ¾Ñ‚Ğ¸Ğ½Ğ¾Ğº  botinok boot ++ âˆšpod âœ“
shop 		Ğ¼Ğ°Ğ³Ğ°Ğ·Ğ¸Ğ½  magaÅ›in  âœ“
shore 		Ğ±ĞµÑ€ĞµĞ³  bereg  âœ“
shortness of breath 		Ğ°ÑÑ‚Ğ¼Ğ°  astma  âœ“
should 		Ğ´Ğ¾Ğ»Ğ¶ĞµĞ½  dolÎ¶een dois:must^^
shut 		Ğ·Ğ°ĞºÑ€Ñ‹Ğ²Ğ°Ñ‚ÑŒ Ğ·Ğ°ĞºÑ€Ñ‹Ñ‚ÑŒ  Å›akrÄ—ivat Å›akrÄ—it secret+++  âœ“
sick 		Ğ±Ğ¾Ğ»ÑŒĞ½Ğ¾Ğ¹  bolnoy polen? mal
side 		Ğ±Ğ¾ĞºĞ¾Ğ²Ğ¾Ğ¹  bokovoy <<

sideboard 		ÑˆĞºĞ°Ñ„  shkapth  s'cupboard <

silent 		Ğ±ĞµĞ·Ğ¼Ğ¾Ğ»Ğ²Ğ½Ñ‹Ğ¹  Ğ±ĞµÅ›-molvnÄ—iy des-molest
sing 		Ğ¿ĞµÑ‚ÑŒ ÑĞ¿ĞµÑ‚ÑŒ  pet spet ?<
sister 		ÑĞµÑÑ‚Ñ€Ğ°  sestra  âœ“
sit 		ÑĞ¸Ğ´ĞµÑ‚ÑŒ Ğ¿Ğ¾ÑĞ¸Ğ´ĞµÑ‚ÑŒ  sidet posidet 
sittingâ€room 		Ğ·Ğ°Ğ»  Å›al Saal âœ“
sit down 		ÑĞ°Ğ´Ğ¸Ñ‚ÑŒÑÑ ÑĞµÑÑ‚ÑŒ  saditsia sest  âœ“
six 		ÑˆĞµÑÑ‚ÑŒ  shest  âœ“
ski 		Ğ»Ñ‹Ğ¶Ğ¸  lÄ—iÎ¶ei leucht?
sky 		Ğ½ĞµĞ±Ğ¾  nebo ğ“‹ğ“‹Ÿ Nebel Nobel Nebo:Merkur <> heaven 
slay 		ÑƒĞ±Ğ¸Ğ²Ğ°Ñ‚ÑŒ ÑƒĞ±Ğ¸Ñ‚ÑŒ  ubivat ubit orbitâ€¦
slaughterhouse 		Ğ±Ğ¾Ğ¹Ğ½Ñ  boynia 
slowly 		Ğ¼ĞµĞ´Ğ»ĞµĞ½Ğ½Ğ¾  medlenno middle:man?
snow 		ÑĞ½ĞµĞ³  sneg  âœ“
snow white 		Ğ±ĞµĞ»Ğ¾ÑĞ½ĞµĞ¶Ğ½Ñ‹Ğ¹  belo.sneÎ¶enÄ—iy bella.Schnee
so 		Ñ‚Ğ°Ğº  takâ„¢ âœ“ 
society 		ĞºĞ»ÑƒĞ±  klub âœ“
soldier 		ÑĞ¾Ğ»Ğ´Ğ°Ñ‚  soldat  âœ“
solicitor 		Ğ°Ğ´Ğ²Ğ¾ĞºĞ°Ñ‚  advokat  âœ“
sole 		Ğ¾Ğ´Ğ¸Ğ½  odin at-one?
solitary 		Ğ¾Ğ´Ğ¸Ğ½  odin Oden?

some 		ĞºÑ‚Ğ¾â€Ñ‚Ğ¾  ktoâ€to que.to2?
somebody 		ĞºÑ‚Ğ¾â€Ñ‚Ğ¾  ktoâ€to 
someone 		ĞºÑ‚Ğ¾â€Ñ‚Ğ¾  ktoâ€to 
some one 		ĞºÑ‚Ğ¾â€Ñ‚Ğ¾  ktoâ€to 

sometimes 		Ğ±Ñ‹Ğ²Ğ°Ğ»Ğ¾  bÄ—ivalo byâ€¦ <<

son 		ÑÑ‹Ğ½  sÄ—in  âœ“ +++
soon 		ÑĞºĞ¾Ñ€Ğ¾  skoro  
soup 		ÑÑƒĞ¿  sup  âœ“
south 		ÑĞ³  Ñg jugo Î±á½Î³Î® augá¸— augora  â€œlight, beamâ€ jour

speak 		Ğ³Ğ¾Ğ²Ğ¾Ñ€Ğ¸Ñ‚ÑŒ Ğ¿Ğ¾Ğ³Ğ¾Ğ²Ğ¾Ñ€Ğ¸Ñ‚ÑŒ  govorit pogovorit  govori:CRY>CALL! << ++ âœ“

speed 		Ğ±Ñ‹ÑÑ‚Ñ€Ğ¾Ñ‚Ğ°  bÄ—istrota fetz âˆšpod best > fast !! +++ âœ“?
speedy 		Ğ±Ñ‹ÑÑ‚Ñ€Ñ‹Ğ¹  bÄ—istrÄ—iy ^^ best > fast ;) âœ“?
sport 		ÑĞ¿Ğ¾Ñ€Ñ‚  sport  âœ“
spot 		Ğ¼ĞµÑÑ‚Ğ¾  mesto Mist!

spring 		Ğ²ĞµÑĞ½Ğ°  vesna !! <<  à¤µà¤¸à¤¨à¥à¤¤ vasantÃ¡, â€œspringâ€
springtime 		Ğ²ĞµÑĞ½Ğ°  vesna  fresh?  Ø¨Ù‡Ø§Ø±â€ (bahÃ¢r, â€œspringâ€), Ancient Greek á¼”Î±Ï (Ã©ar), Latin ver

squirrel 		Ğ±ĞµĞ»ĞºĞ°  belka /

stairs 		Ğ»ĞµÑÑ‚Ğ½Ğ¸Ñ†Ğ°  lestnissa ??  *lÄ›zti (â€œto climbâ€)  Î»Î±Ï‡ÏÏ‚ (lakhÃºs, â€œlowâ€)
staircase 		Ğ»ĞµÑÑ‚Ğ½Ğ¸Ñ†Ğ°  lestnissa 

stand 		Ğ±ÑƒĞ´ĞºĞ°  budka âˆšpod
stand up to 		Ğ°Ñ€Ñ‚Ğ°Ñ‡Ğ¸Ñ‚ÑŒÑÑ  artachitsia ?

start 		Ğ½Ğ°Ñ‡Ğ°Ğ»Ğ¾  nachalo  Ğ½Ğ°Ñ‡Ñ§Ğ»Ğ¾ âˆšNEUâ€¦ <<âœ“

station 		Ğ²Ğ¾ĞºĞ·Ğ°Ğ» ÑÑ‚Ğ°Ğ½Ñ†Ğ¸Ñ  vokÅ›al stanssiiaâœ“  standtionâœ“

stay 		Ğ¾ÑÑ‚Ğ°Ğ²Ğ°Ñ‚ÑŒÑÑ Ğ¾ÑÑ‚Ğ°Ñ‚ÑŒÑÑ  ostavatsia ostatsia  !!! âˆšstatic +++ <<<
stay over 		Ğ¾ÑÑ‚Ğ°Ğ²Ğ°Ñ‚ÑŒÑÑ Ğ¾ÑÑ‚Ğ°Ñ‚ÑŒÑÑ  ostavatsia ostatsia  âˆšSTAT ostentativ guest?

steak 		Ğ±Ğ¸Ñ„ÑˆÑ‚ĞµĞºÑ  bifshteksâœ“! <>  bifteki âœ“
storage battery 		Ğ°ĞºĞºÑƒĞ¼ÑƒĞ»ÑÑ‚Ğ¾Ñ€  akkumuliator âœ“
store 		Ğ¼Ğ°Ğ³Ğ°Ğ·Ğ¸Ğ½  magazin âœ“
stork 		Ğ°Ğ¸ÑÑ‚  aist << air Ã¤ste easter ... ?
storm 		Ğ±ÑƒÑ€Ñ  buria boreal ~âœ“ vs quria!
story 		Ğ¸ÑÑ‚Ğ¾Ñ€Ğ¸Ñ  istoriia  âœ“
stress 		Ğ°ĞºÑ†ĞµĞ½Ñ‚  akssent ~âœ“
strike 		Ğ±Ğ¸Ñ‚ÑŒ ÑƒĞ´Ğ°Ñ€Ğ¸Ñ‚ÑŒ  bit udarit bat audire:go
striking 		Ğ±Ñ€Ğ¾ÑĞºĞ¸Ğ¹  broskiy brÃ¼sk... << âœ“
stroll 		Ğ³ÑƒĞ»ÑÑ‚ÑŒ Ğ¿Ğ¾Ğ³ÑƒĞ»ÑÑ‚ÑŒ  guliat poguliat GOâ€¦
strong 		ÑĞ¸Ğ»ÑŒĞ½Ñ‹Ğ¹  silnÄ—iy <<<<< sÃ­ela:sky?  seul,saal?
struggle 		Ğ±Ğ¾Ñ€Ğ¾Ñ‚ÑŒÑÑ  borotsia war:Borussia âœ“?
student 		ÑÑ‚ÑƒĞ´ĞµĞ½Ñ‚ĞºĞ°  studentka  âœ“
stupid 		Ğ³Ğ»ÑƒĞ¿Ñ‹Ğ¹  glupÄ—iy  âœ“
subscriber 		Ğ°Ğ±Ğ¾Ğ½ĞµĞ½Ñ‚  abonent âœ“
such 		Ñ‚Ğ°Ğº  takâ„¢ âœ“ <>
such a 		ĞºĞ°Ğº  kak  queque ~âœ“
such as 		ĞºĞ°Ğº  kak 
suddenly 		Ğ²Ğ´Ñ€ÑƒĞ³  vdrug abrugt~~
summer 		Ğ»ĞµÑ‚Ğ¾  leto levt:white?  year/laithe (â€œdayâ€)
supper 		ÑƒĞ¶Ğ¸Ğ½  uÎ¶ein ESSEN!  ÑƒĞ³ÑŠ ugÅ­ *jugÑŠ ^^ South/Noon
surname 		Ñ„Ğ°Ğ¼Ğ¸Ğ»Ğ¸Ñ  familiia âœ“
swamp 		Ğ±Ğ¾Ğ»Ğ¾Ñ‚Ğ¾  boloto 
swift 		Ğ±Ñ‹ÑÑ‚Ñ€Ñ‹Ğ¹  bÄ—istrÄ—iy FAST<best^^ âœ“?

swiftly 		Ğ±Ñ‹ÑÑ‚Ñ€Ğ¾ ÑĞºĞ¾Ñ€Ğ¾  bÄ—istro skoro ^^

swim 		Ğ¿Ğ»Ğ°Ğ²Ğ°Ñ‚ÑŒ  plavat pleuvoirâœ“
swimmingâ€bath 		Ğ±Ğ°ÑÑĞµĞ¹Ğ½ Ğ´Ğ»Ñ Ğ¿Ğ»Ğ°Ğ²Ğ°Ğ½Ğ¸Ñ  basseyn dlia plavaniia Bassin dela Pleuvanau +++++<< âœ“
swimmingâ€pool 		Ğ±Ğ°ÑÑĞµĞ¹Ğ½ Ğ´Ğ»Ñ Ğ¿Ğ»Ğ°Ğ²Ğ°Ğ½Ğ¸Ñ  basseyn dlia plavaniia 
table 		ÑÑ‚Ğ¾Ğ»  stol  ~âœ“ Stuhl@Stell
take 		Ğ¿Ñ€Ğ¸Ğ½Ğ¸Ğ¼Ğ°Ñ‚ÑŒ  prinimat prendre++ âœ“
take in 		Ğ¿Ñ€Ğ¸Ğ½Ğ¸Ğ¼Ğ°Ñ‚ÑŒ  prinimat pre.Nehme^^ âœ“!++<<
take along 		Ğ·Ğ°Ğ±Ğ¸Ñ€Ğ°Ñ‚ÑŒ Ğ·Ğ°Ğ±Ñ€Ğ°Ñ‚ÑŒ  Å›abirat Å›abrat 
take away 		Ğ·Ğ°Ğ±Ğ¸Ñ€Ğ°Ñ‚ÑŒ Ğ·Ğ°Ğ±Ñ€Ğ°Ñ‚ÑŒ  Å›abirat Å›abrat 
take into account 		ÑÑ‡Ğ¸Ñ‚Ğ°Ñ‚ÑŒ  schitat  Zitat;)
take over 		Ğ¿Ğ¾ĞºÑƒĞ¿Ğ°Ñ‚ÑŒ ĞºÑƒĞ¿Ğ¸Ñ‚ÑŒ  pokupat kupit 
talk 		Ğ³Ğ¾Ğ²Ğ¾Ñ€Ğ¸Ñ‚ÑŒ Ğ¿Ğ¾Ğ³Ğ¾Ğ²Ğ¾Ñ€Ğ¸Ñ‚ÑŒ  govorit pogovorit govori:CRY/call^^  
tall 		Ğ²Ñ‹ÑĞ¾ĞºĞ¸Ğ¹  vÄ—isokiy â„¢ feist? <<<<
tangle 		Ğ±ĞµÑĞ¿Ğ¾Ñ€ÑĞ´Ğ¾Ğº  besporiadok 
tank 		Ğ±Ğ°Ğº  bak  
target 		Ñ†ĞµĞ»ÑŒ  ssel Ziel âœ“ ++
tasteless 		Ğ±ĞµĞ·Ğ²ĞºÑƒÑĞ½Ñ‹Ğ¹  Ğ±ĞµÅ›-vkusnÄ—iy beaucoup,verkost?<<
tasty 		Ğ°Ğ¿Ğ¿ĞµÑ‚Ğ¸Ñ‚Ğ½Ñ‹Ğ¹  appetitnÄ—iy âœ“
tea 		Ñ‡Ğ°Ğ¹  chay  âœ“
teacher 		ÑƒÑ‡Ğ¸Ñ‚ĞµĞ»ÑŒ  uchitel ^^
tell 		Ğ³Ğ¾Ğ²Ğ¾Ñ€Ğ¸Ñ‚ÑŒ ÑĞºĞ°Ğ·Ğ°Ñ‚ÑŒ  govorit skaÅ›at chat!<<< âœ“/EG
tell a lie 		Ğ±Ñ€ĞµÑ…Ğ°Ñ‚ÑŒ  brexat  Bruchâœ“? sprechen;)
ten 		Ğ´ĞµÑÑÑ‚ÑŒ  desiat dix âœ“
tenant 		Ğ°Ñ€ĞµĞ½Ğ´Ğ°Ñ‚Ğ¾Ñ€  arendator !?
testimony 		Ğ°Ñ‚Ñ‚ĞµÑÑ‚Ğ°Ñ‚  attestat âœ“
text 		Ñ‚ĞµĞºÑÑ‚  tekst  âœ“
thankful 		Ğ±Ğ»Ğ°Ğ³Ğ¾Ğ´Ğ°Ñ€Ğ½Ñ‹Ğ¹  blagodarnÄ—iy 
that 		Ñ‡Ñ‚Ğ¾  chto  âœ“
that over there 		ÑÑ‚Ğ¾  aito Thato Ñ<TH!
that way 		Ñ‚Ğ°Ğº  tak !
theatre 		Ñ‚ĞµĞ°Ñ‚Ñ€  teatr  âœ“
thee and thou 		Ğ±Ñ‹Ñ‚ÑŒ Ğ½Ğ° Ñ‚Ñ‹  bÄ—it na tÄ—i 
then 		Ğ¿Ğ¾Ñ‚Ğ¾Ğ¼   potom pan.time ~âœ“
then		Ñ‚Ğ¾Ğ³Ğ´Ğ° togda[n] der.Tag? 
theologian 		Ğ±Ğ¾Ğ³Ğ¾ÑĞ»Ğ¾Ğ²  bogoslov bog=god
theology 		Ğ±Ğ¾Ğ³Ğ¾ÑĞ»Ğ¾Ğ²Ğ¸Ğµ  bogoslovie 
there 		Ğ²Ğ¾Ñ‚  vot 
the Antarctic 		ĞĞ½Ñ‚Ğ°Ñ€ĞºÑ‚Ğ¸ĞºĞ°  antarktika  âœ“
the Netherlands 		ĞĞ¸Ğ´ĞµÑ€Ğ»Ğ°Ğ½Ğ´Ñ‹  niderlandÄ—i 
thigh 		Ğ±ĞµĞ´Ñ€Ğ¾ Ğ»ÑĞ¶ĞºĞ°  bedro liaÎ¶eka âˆšpod /leg? <<
thing 		Ğ²ĞµÑ‰ÑŒ  vesch   
think 		Ğ´ÑƒĞ¼Ğ°Ñ‚ÑŒ Ğ¿Ğ¾Ğ´ÑƒĞ¼Ğ°Ñ‚ÑŒ  dumat podumat 
third 		Ñ‚Ñ€ĞµÑ‚Ğ¸Ğ¹  tretiy 
this evening 		ÑĞµĞ³Ğ¾Ğ´Ğ½Ñ Ğ²ĞµÑ‡ĞµÑ€Ğ¾Ğ¼  segodnia vecherom 
this morning 		ÑĞµĞ³Ğ¾Ğ´Ğ½Ñ ÑƒÑ‚Ñ€Ğ¾Ğ¼  segodnia utrom 
those 		ÑÑ‚Ğ¾  aito 
though 		Ñ…Ğ¾Ñ‚Ñ  xotia 
thrash 		Ğ±ÑƒÑ…Ğ°Ñ‚ÑŒ Ğ±ÑƒÑ…Ğ½ÑƒÑ‚ÑŒ  buxat buxnut 
three 		Ñ‚Ñ€Ğ¸  tri  âœ“
throat 		Ğ³Ğ¾Ñ€Ğ»Ğ¾  gorlo 
through 		Ğ¸Ğ·â€Ğ·Ğ°  iÅ›â€Å›a 
thumb 		Ğ±Ğ¾Ğ»ÑŒÑˆĞ¾Ğ¹ Ğ¿Ğ°Ğ»ĞµÑ†  bolshoy paless 
thus 		Ñ‚Ğ°Ğº  tak  âœ“
ticket 		Ğ±Ğ¸Ğ»ĞµÑ‚  bilet  âœ“
tiger 		Ñ‚Ğ¸Ğ³Ñ€  tigr  âœ“
time 		Ğ²Ñ€ĞµĞ¼Ñ  vremia 
tin 		Ğ±Ğ°Ğ½ĞºĞ°  banka 
tin can 		Ğ±Ğ°Ğ½ĞºĞ°  banka  âœ“
to 		Ğ² Ğº Ğ½Ğ°  v k na 
today 		ÑĞµĞ³Ğ¾Ğ´Ğ½Ñ  segodnia 
together 		Ğ²Ğ¼ĞµÑÑ‚Ğµ  vmeste 
tomorrow 		Ğ·Ğ°Ğ²Ñ‚Ñ€Ğ°  Å›avtra 
tongue 		ÑĞ·Ñ‹Ğº  iaÅ›Ä—ik 
too 		Ñ‚Ğ°ĞºĞ¶Ğµ Ñ‚Ğ¾Ğ¶Ğµ  takÎ¶ee toÎ¶ee 
topical 		Ğ°ĞºÑ‚ÑƒĞ°Ğ»ÑŒĞ½Ğ¾ÑÑ‚ÑŒ  aktualnost 
topicality 		Ğ°ĞºÑ‚ÑƒĞ°Ğ»ÑŒĞ½Ğ¾ÑÑ‚ÑŒ  aktualnost 
toward 		Ğ² Ğº Ğ½Ğ°  v k na 
towards 		Ğ² Ğº Ğ½Ğ°  v k na 
towel 		Ğ¿Ğ¾Ğ»Ğ¾Ñ‚ĞµĞ½Ñ†Ğµ  polotensse 
tower 		Ğ±Ğ°ÑˆĞ½Ñ  bashnia 
town 		Ğ³Ğ¾Ñ€Ğ¾Ğ´  gorod 
translate 		Ğ¿ĞµÑ€ĞµĞ²Ğ¾Ğ´Ğ¸Ñ‚ÑŒ Ğ¿ĞµÑ€ĞµĞ²ĞµÑÑ‚Ğ¸  perevodit perevesti 
transmit 		Ğ¿Ğ¾ÑÑ‹Ğ»Ğ°Ñ‚ÑŒ Ğ¿Ğ¾ÑĞ»Ğ°Ñ‚ÑŒ  posÄ—ilat poslat 
travel 		Ğ¿ÑƒÑ‚ĞµÑˆĞµÑÑ‚Ğ²Ğ¾Ğ²Ğ°Ñ‚ÑŒ  puteshestvovat 
tree 		Ğ´ĞµÑ€ĞµĞ²Ğ¾  derevo 
trip 		Ğ¿ÑƒÑ‚ĞµÑˆĞµÑÑ‚Ğ²Ğ¸Ğµ  puteshestvie 
trouble 		Ğ²Ğ¾Ğ¿Ñ€Ğ¾Ñ Ğ¿Ñ€Ğ¾Ğ±Ğ»ĞµĞ¼Ğ°  vopros problema 
trousers 		Ğ±Ñ€ÑĞºĞ¸  bruki 
truck 		Ğ³Ñ€ÑƒĞ·Ğ¾Ğ²Ğ¾Ğ¹ Ğ°Ğ²Ñ‚Ğ¾Ğ¼Ğ¾Ğ±Ğ¸Ğ»ÑŒ  gruÅ›ovoy avtomobil 
trunk 		Ñ‡ĞµĞ¼Ğ¾Ğ´Ğ°Ğ½  chemodan 
tummy 		Ğ±Ñ€ÑÑ…Ğ¾  bruxo 
tup 		Ğ±Ğ°Ñ€Ğ°Ğ½  baran 
twaddle 		Ğ±Ñ€ĞµÑ…Ğ°Ñ‚ÑŒ  brexat 
twenty 		Ğ´Ğ²Ğ°Ğ´Ñ†Ğ°Ñ‚ÑŒ  dvadssat 
two 		Ğ´Ğ²Ğ° Ğ´Ğ²Ğµ  dva dve 
type 		Ğ¿ĞµÑ‡Ğ°Ñ‚Ğ°Ñ‚ÑŒ Ğ¾Ñ‚Ğ¿ĞµÑ‡Ğ°Ñ‚Ğ°Ñ‚ÑŒ  pechatat otpechatat 
typewriter 		Ğ¿Ğ¸ÑˆÑƒÑ‰Ğ°Ñ Ğ¼Ğ°ÑˆĞ¸Ğ½ĞºĞ°  pishuschaia mashinka 
umpire 		Ğ°Ñ€Ğ±Ğ¸Ñ‚Ñ€  arbitr 
uncle 		Ğ´ÑĞ´Ñ  diadia 
underneath 		Ğ²Ğ½Ğ¸Ğ·Ñƒ  vniÅ›u 
understand 		Ğ¿Ğ¾Ğ½Ğ¸Ğ¼Ğ°Ñ‚ÑŒ Ğ¿Ğ¾Ğ½ÑÑ‚ÑŒ  ponimat poniat 
unemployed 		Ğ±ĞµĞ·Ñ€Ğ°Ğ±Ğ¾Ñ‚Ğ½Ñ‹Ğ¹  Ğ±ĞµÅ›-rabotnÄ—iy 
unemployment 		Ğ±ĞµĞ·Ñ€Ğ°Ğ±Ğ¾Ñ‚Ğ¸Ñ†Ğ°  Ğ±ĞµÅ›-rabotissa 
unfortunately 		Ğº ÑĞ¾Ğ¶Ğ°Ğ»ĞµĞ½Ğ¸Ñ  k soÎ¶ealeniÑ 
university 		ÑƒĞ½Ğ¸Ğ²ĞµÑ€ÑĞ¸Ñ‚ĞµÑ‚  universitet  âœ“
university graduate 		Ğ°ĞºĞ°Ğ´ĞµĞ¼Ğ¸Ğº  akademik 
unknown 		Ğ±ĞµĞ·Ğ²ĞµÑÑ‚Ğ½Ñ‹Ğ¹  Ğ±ĞµÅ›-vestnÄ—iy 
upâ€toâ€date 		Ğ°ĞºÑ‚ÑƒĞ°Ğ»ÑŒĞ½Ğ¾ÑÑ‚ÑŒ  aktualnost 
up 		Ğ½Ğ°Ğ²ĞµÑ€Ñ…  naverx 
uphill 		Ğ½Ğ°Ğ²ĞµÑ€Ñ…  naverx 
upon 		Ğ¿Ñ€Ğ¾Ñ‚Ğ¸Ğ²  protiv 
upperâ€arm 		Ğ²ĞµÑ€Ñ…Ğ½ÑÑ Ñ‡Ğ°ÑÑ‚ÑŒ Ñ€ÑƒĞºĞ¸  verxniaia chast ruki 
upper arm 		Ğ²ĞµÑ€Ñ…Ğ½ÑÑ Ñ‡Ğ°ÑÑ‚ÑŒ Ñ€ÑƒĞºĞ¸  verxniaia chast ruki 
upstairs 		Ğ½Ğ°Ğ²ĞµÑ€Ñ…Ñƒ  naverxu 
upwards 		Ğ½Ğ°Ğ²ĞµÑ€Ñ…  naverx 
useful 		Ğ¿Ğ¾Ğ»ĞµĞ·Ğ½Ñ‹Ğ¹  poleÅ›nÄ—iy 
useless 		Ğ±ĞµÑĞ¿Ğ¾Ğ»ĞµĞ·Ğ½Ñ‹Ğ¹  bespoleÅ›nÄ—iy 
usually 		Ğ¾Ğ±Ñ‹Ñ‡Ğ½Ğ¾  obÄ—ichno 
valiant 		Ğ±Ñ€Ğ°Ğ²Ñ‹Ğ¹  bravÄ—iy 
valuable 		Ğ´Ğ¾Ñ€Ğ¾Ğ³Ğ¾Ğ¹  dorogoy 
vase 		Ğ²Ğ°Ğ·Ğ°  vaÅ›a  âœ“
velvet 		Ğ±Ğ°Ñ€Ñ…Ğ°Ñ‚Ğ½Ñ‹Ğ¹  barxatnÄ—iy 
vend 		Ğ¿Ñ€Ğ¾Ğ´Ğ°Ğ²Ğ°Ñ‚ÑŒ Ğ¿Ñ€Ğ¾Ğ´Ğ°Ñ‚ÑŒ  prodavat prodat 
very 		Ğ¾Ñ‡ĞµĞ½ÑŒ  ochen 
very much 		Ğ¾Ñ‡ĞµĞ½ÑŒ  ochen 
vessel 		Ğ±Ğ°Ğº  bak 
view 		ÑĞ¼Ğ¾Ñ‚Ñ€ĞµÑ‚ÑŒ Ğ¿Ğ¾ÑĞ¼Ğ¾Ñ‚Ñ€ĞµÑ‚ÑŒ  smotret posmotret 
vigour 		Ğ°ĞºÑ‚Ğ¸Ğ²Ğ½Ğ¾ÑÑ‚ÑŒ  aktivnost 
village 		Ğ°ÑƒĞ»  aul 
visa 		Ğ²Ğ¸Ğ·Ğ°  viÅ›a  âœ“
visit 		Ğ¿Ğ¾ÑĞµÑ‰Ğ°Ñ‚ÑŒ Ğ¿Ğ¾ÑĞµÑ‚Ğ¸Ñ‚ÑŒ  poseschat posetit 
visitor 		Ğ¿Ğ¾ÑĞµÑ‚Ğ¸Ñ‚ĞµĞ»ÑŒ  posetitel 
visÃ© 		Ğ²Ğ¸Ğ·Ğ°  viÅ›a  âœ“
vocabulary 		ÑĞ»Ğ¾Ğ²Ğ°Ñ€ÑŒ  slovar 
vodka 		Ğ²Ğ¾Ğ´ĞºĞ°  vodka  âœ“
voyage 		Ğ¿ÑƒÑ‚ĞµÑˆĞµÑÑ‚Ğ²Ğ¸Ğµ  puteshestvie 
wail 		Ğ°Ñ…Ğ°Ñ‚ÑŒ  axat 
wainscot 		Ğ·Ğ°Ğ±Ğ¸Ñ€Ğ°Ñ‚ÑŒ Ğ·Ğ°Ğ±Ñ€Ğ°Ñ‚ÑŒ  Å›abirat Å›abrat 
wait 		Ğ¶Ğ´Ğ°Ñ‚ÑŒ Ğ¿Ğ¾Ğ´Ğ¾Ğ¶Ğ´Ğ°Ñ‚ÑŒ  Î¶edat podoÎ¶edat 
waitress 		Ğ¾Ñ„Ğ¸Ñ†Ğ¸Ğ°Ğ½Ñ‚ĞºĞ°  othissiantka  << p/t?
wait for 		Ğ¶Ğ´Ğ°Ñ‚ÑŒ Ğ¿Ğ¾Ğ´Ğ¾Ğ¶Ğ´Ğ°Ñ‚ÑŒ  Î¶edat podoÎ¶edat 
wake 		Ñ€Ğ°Ğ·Ğ±ÑƒĞ´Ğ¸Ñ‚ÑŒ  raÅ›budit 
wake up 		Ñ€Ğ°Ğ·Ğ±ÑƒĞ´Ğ¸Ñ‚ÑŒ  raÅ›budit 
walk 		Ñ…Ğ¾Ğ´Ğ¸Ñ‚ÑŒ Ğ¿Ğ¾Ñ…Ğ¾Ğ´Ğ¸Ñ‚ÑŒ  xodit poxodit 
wander 		Ğ±Ñ€Ğ¾Ğ´Ğ¸Ñ‚ÑŒ  brodit 
want 		Ñ…Ğ¾Ñ‚ĞµÑ‚ÑŒ Ğ·Ğ°Ñ…Ğ¾Ñ‚ĞµÑ‚ÑŒ  xotet Å›axotet 
warrior 		Ğ°Ñ€Ğ¼ĞµĞµÑ† Ğ±Ğ¾ĞµÑ† Ğ±Ğ¾Ñ€ĞµÑ†  armeess boess boress 
wart 		Ğ±Ğ¾Ñ€Ğ¾Ğ´Ğ°Ğ²ĞºĞ°  borodavka 
wash 		Ğ±ÑƒÑ‡Ğ¸Ñ‚ÑŒ  buchit 
waste 		Ğ±Ñ€Ğ°Ğº  brak 
watch 		Ñ‡Ğ°ÑÑ‹  chasÄ—i 
waterâ€bottle 		Ğ±Ğ°ĞºĞ»Ğ°Ğ³Ğ°  baklaga 
waterâ€colour 		Ğ°ĞºĞ²Ğ°Ñ€ĞµĞ»ÑŒ  akvarel 
water 		Ğ²Ğ¾Ğ´Ğ°  voda 
way 		Ğ´Ğ¾Ñ€Ğ¾Ğ³Ğ°  doroga 
wealth 		Ğ±Ğ¾Ğ³Ğ°Ñ‚ÑÑ‚Ğ²Ğ¾  bogatstvo 
wealthy 		Ğ±Ğ¾Ğ³Ğ°Ñ‚Ñ‹Ğ¹  bogatÄ—iy 
weather 		Ğ¿Ğ¾Ğ³Ğ¾Ğ´Ğ°  pogoda 
week 		Ğ½ĞµĞ´ĞµĞ»Ñ  nedelia 
weep 		Ğ¿Ğ»Ğ°ĞºĞ°Ñ‚ÑŒ Ğ·Ğ°Ğ¿Ğ»Ğ°ĞºĞ°Ñ‚ÑŒ  plakat Å›aplakat 
wellâ€off 		Ğ±Ğ¾Ğ³Ğ°Ñ‚Ñ‹Ğ¹  bogatÄ—iy 
well 		Ñ…Ğ¾Ñ€Ğ¾ÑˆĞ¾  xorosho 
wench 		Ğ´ĞµĞ²ÑƒÑˆĞºĞ°  devushka 
what 		Ñ‡Ñ‚Ğ¾  chto  âœ“
what a 		ĞºĞ°Ğº  kak << quaque
what for 		Ğ¿Ğ¾Ñ‡ĞµĞ¼Ñƒ  pochemu 
wheeziness 		Ğ°ÑÑ‚Ğ¼Ğ°  astma âœ“
wheezy 		Ğ°ÑÑ‚Ğ¼Ğ°Ñ‚Ğ¸Ñ‡ĞµÑĞºĞ¸Ğ¹  astmaticheskiy 
when 		ĞºĞ¾Ğ³Ğ´Ğ°  kogda 
where 		Ğ³Ğ´Ğµ  gde  zu-da??<<
whereas 		Ğ·Ğ° Ğ¿Ğ¾ĞºĞ°  Å›a poka 
which 		ĞºÑ‚Ğ¾  kto 
while 		Ğ·Ğ° Ğ¿Ğ¾ĞºĞ°  Å›a poka 
whilst 		Ğ·Ğ° Ğ¿Ğ¾ĞºĞ°  Å›a poka 
whip 		Ğ±Ğ¸Ñ‡ĞµĞ²Ğ°Ñ‚ÑŒ  bichevat 
white 		Ğ±ĞµĞ»Ñ‹Ğ¹  belÄ—iy[k] âœ“  bei beige bveiÅ› blanc vs black!! <<
who 		ĞºÑ‚Ğ¾  kto  âœ“
why 		Ğ¿Ğ¾Ñ‡ĞµĞ¼Ñƒ  pochemu  <<< EG?
why? 		Ğ¿Ğ¾Ñ‡ĞµĞ¼Ñƒ?  pochemu? 
windfall 		Ğ±Ñ€Ğ°Ğº  brak ?
window 		Ğ¾ĞºĞ½Ğ¾  okno  âœ“
wine 		Ğ²Ğ¸Ğ½Ğ¾  vino  âœ“

wind 		Ğ²ĞµÑ‚ĞµÑ€  veter âœ“  <>
winter 		Ğ·Ğ¸Ğ¼Ğ°  Å›ima zimmer time <<

wish 		Ğ¶ĞµĞ»Ğ°Ñ‚ÑŒ Ğ¿Ğ¾Ğ¶ĞµĞ»Ğ°Ñ‚ÑŒ  Î¶eelat poÎ¶eelat 

witch 		Ğ±Ğ°Ğ±Ğ°â€ÑĞ³Ğ°  babaâ€iaga ;) << humbaba!

with 		Ñ  s as zu
within 		Ğ² Ğ½Ğ°  v na  vith ina <3 <<<

without 		Ğ±ĞµĞ·  Ğ±ĞµÅ›- des- weg-

without a name 		Ğ±ĞµĞ·Ñ‹Ğ¼ÑĞ½Ğ½Ñ‹Ğ¹  Ğ±ĞµÅ›-Ä—imiannÄ—iy 
withstand 		Ğ°Ñ€Ñ‚Ğ°Ñ‡Ğ¸Ñ‚ÑŒÑÑ  artachitsia 
with young 		Ğ±ĞµÑ€ĞµĞ¼ĞµĞ½Ğ½Ğ°Ñ  beremennaia 
womanâ€chaser 		Ğ±Ğ°Ğ±Ğ½Ğ¸Ğº  babnik ;)
woods 		Ğ»ĞµÑ  [fo]les  âœ“
word 		ÑĞ»Ğ¾Ğ²Ğ¾  slovo[d] Slaven sloWord @ lip? <<
work 		Ñ€Ğ°Ğ±Ğ¾Ñ‚Ğ°Ñ‚ÑŒ  rabotat âœ“  *karbeit
worker 		Ñ€Ğ°Ğ±Ğ¾Ñ‡Ğ¸Ğ¹  rabochiy âœ“
working man 		Ñ€Ğ°Ğ±Ğ¾Ñ‡Ğ¸Ğ¹  rabochiy âœ“
workman 		Ñ€Ğ°Ğ±Ğ¾Ñ‡Ğ¸Ğ¹  rabochiy âœ“

worship 		Ğ±Ğ¾Ğ³Ğ¾Ñ‚Ğ²Ğ¾Ñ€Ğ¸Ñ‚ÑŒ  bogotvorit <> Gott << ^^

writer 		Ğ°Ğ²Ñ‚Ğ¾Ñ€  avtor  âœ“
write down 		Ğ·Ğ°Ğ¿Ğ¸ÑÑ‹Ğ²Ğ°Ñ‚ÑŒ Ğ·Ğ°Ğ¿Ğ¸ÑĞ°Ñ‚ÑŒ  Å›apisÄ—ivat Å›apisat 
yacht 		ÑÑ…Ñ‚Ğ°  iaxta  âœ“
year 		Ğ³Ğ¾Ğ´  god <<>> Jahrde !!
yes 		Ğ´Ğ°  da  âœ“ tja
yesterday 		Ğ²Ñ‡ĞµÑ€Ğ°  vchera  âœ“
yet 		ÑƒĞ¶Ğµ  ~yuÎ¶ee 

yon 		Ñ‚Ğ°Ğ¼  tam  
yonder 		Ñ‚Ğ°Ğ¼  tam  <> kar.tam!! <<<<

young 		Ğ¼Ğ¾Ğ»Ğ¾Ğ´Ğ¾Ğ¹  molodoy  ??
young woman 		Ğ±Ğ°Ñ€Ñ‹ÑˆĞ½Ñ  barÄ—ishnia 
your 		Ñ‚Ğ²Ğ¾Ñ‘ Ñ‚Ğ²Ğ¾Ğ¹ Ñ‚Ğ²Ğ¾Ñ  tvoÑ‘ tvoy tvoia  tuâœ“
zero 		Ğ½Ğ¾Ğ»ÑŒ  nol âœ“

Saturday 		ÑÑƒĞ±Ğ±Ğ¾Ñ‚Ğ°  subbota âœ“
Thursday 		Ñ‡ĞµÑ‚Ğ²ĞµÑ€Ğ³  chetverg 
Wednesday 		ÑÑ€ĞµĞ´Ğ°  sreda  âœ“
holiday 		Ğ¿Ñ€Ğ°Ğ·Ğ´Ğ½Ğ¸Ğº  praÅ›dnik 
presentâ€day 		Ğ°ĞºÑ‚ÑƒĞ°Ğ»ÑŒĞ½Ğ¾ÑÑ‚ÑŒ  aktualnost 
today 		ÑĞµĞ³Ğ¾Ğ´Ğ½Ñ  segodnia 
yesterday 		Ğ²Ñ‡ĞµÑ€Ğ°  vchera  âœ“
