Afrika 		Africa 
Armenien 		Armenia 
Asien 		Asia 
Atlanten 		Atlantic Atlantic Ocean 
Australien 		Australia 
Bajern 		Bavaria 
Belgien 		Belgium 
Bibel 		Bible 
Bottenviken 		Gulf of Bothnia 
Bottniska viken 		Gulf of Bothnia 
Brasilien 		Brazil 
Brittannien 		Britain Great Britain 
Bulgarien 		Bulgaria 
Dalarna 		Dalecarlia 
Danmark 		Denmark 
Egypten 		Egypt 
England 		England 
Estland 		Estonia 
Europa 		Europa 
Finland 		Finland 
Flandern 		Flanders 
Frankrike 		France 
Förenta staterna 		United States of America USA 
Grekland 		Greece 
Gud 		God 
Holland 		Holland 
Indien 		India 
Irland 		Ireland 
Ishavet 		Arctic Ocean 
Island 		Iceland 
Italien 		Italy 
Jon Blund 		the Dustman the Sandman Wee Willie Winkie 
Kaspiska havet 		Caspian Sea 
Kristi himmelsfärdsdag 		Ascension Day 
Kristus 		Christ 
Köpenhamn 		Copenhagen 
Lappland 		Lapland 
Lettland 		Latvia 
Medelhavet 		Mediterranean 
Mongoliet 		Mongolia 
Nederländerna 		Holland the Netherlands 
Nordamerika 		North America 
Norden 		Scandinavia 
Nordpolen 		Arctic the Arctic 
Nordsjön 		North Sea 
Norge 		Norway 
Polen 		Poland 
Rhen 		Rhine 
Rom 		Rome 
Rumänien 		Romania 
Ryssland 		Russia 
Rödluva 		Little Red Ridinghood 
Schweiz 		Switzerland 
Siberien 		Siberia 
Sicilien 		Sicily 
Skandinavien 		Scandinavia 
Skottland 		Scotland 
Snövit 		Little Snow White 
Spanien 		Spain 
Spetsbergen 		Spitsbergen 
Storbrittannien 		Britain Great Britain 
Sverige 		Sweden 
Sydamerika 		South America 
Sydpolen 		Antarctic the Antarctic 
Söderhavet 		Pacific Pacific Ocean 
TV 		television TV 
Turkiet 		Turkey 
Tyskland 		Germany 
‐bar 		‐able ‐ible 
‐lös 		‐less un‐ 
USA 		United States of America USA 
Ukraina 		Ukraine the Ukraine 
Ungern 		Hungary 
Västindien 		West Indies 
Yttersta östern 		Far East 
abbedissa 		abbess 
abborre 		bass 
abbot 		abbot 
abbotskloster 		abbey 
abnorm 		deformed 
abonnemang 		subscription 
abonnent 		subscriber 
abonnera 		subscribe subscribe to 
absolutist 		teetotaller total abstainer 
accent 		accent stress 
accept 		acceptance admission 
accis 		excise excise‐duty 
ack 		ah oh ow 
ackja 		reindeer‐sledge reindeer‐sleigh 
ackompanjemang 		accompaniment 
ackord 		chord 
ackurat 		accurate on time prompt punctual 
ackusativ 		accusative 
ackuschör 		obstetrician 
ackuschörska 		midwife obstetrician 
ackvisition 		acquirement acquisition 
addition 		addition 
adel 		nobility 
aderton 		eighteen 
adertonde 		eighteenth 
adjektiv 		adjective 
adjunkt 		curate 
adjutant 		adjutant aide‐de‐camp 
adjö 		adieu farewell bye goodbye 
adjö så länge 		bye goodbye so long 
adlig 		of noble birth 
administratör 		manager 
adress 		address 
adressant 		sender 
adressera 		address 
adresskalender 		address list 
adresskort 		dispatch note 
adresslapp 		dispatch note 
adverb 		adverb 
affektation 		affectation 
affisch 		notice placard poster 
affischera 		placard post post up 
affär 		affair business business deal case matter 
affärsförbindelse 		business relation 
affärsgata 		shopping street 
affärshus 		company firm 
affärsman 		businessman 
affärsvän 		business friend 
afrikan 		African 
afrikansk 		African 
afton 		evening 
aftonbön 		night prayers 
aftonmåltid 		evening meal supper 
aga 		castigation chastisement 
agent 		agent 
agentur 		agency 
agg 		discontent discontentedness displeasure dissatisfaction 
agitation 		agitation commotion 
agn 		bait 
aja sig 		groan 
akademi 		academy 
aktie 		share 
aktiv 		active in action 
aktris 		actress 
aktör 		actor 
akvarell 		water‐colour 
akvavit 		brandy 
akvedukt 		aqueduct 
al 		alder 
alarm 		alarm 
alarmere 		alarm raise the alarm sound the alarm 
aldrig 		never 
alfabet 		alphabet 
alg 		alga seaweed 
alkohol 		alcohol 
allaredan 		already by now yet 
alldaglig 		daily 
alldeles 		at all entirely quite wholly 
alldeles icke 		not at all 
allegorisk 		allegoric 
allehanda 		all every kind of 
allestädes 		all about everywhere 
allhelgonadag 		All Hallows All Saints' Day 
allians 		alliance 
allmakt 		omnipotence 
allmogespråk 		dialect 
allmosa 		alms charity 
allmän 		public 
allmänhet 		generality universality 
allrådande 		almighty all‐powerful omnipotent 
allsmäktig 		almighty all‐powerful omnipotent 
alls icke 		not at all 
allt 		universe 
alltefter 		according as according to as by 
alltemellanåt 		several times sometimes 
alltför 		too too much 
alltid 		always ever 
alltifrån 		from since 
allting 		all altogether everything 
alludera 		allude hint 
allvarlig 		earnest serious staid 
allvetande 		all‐knowing omniscient 
allé 		avenue 
alm 		elm 
almanacka 		almanac 
alster 		product 
alstra 		afford bear produce 
alstring 		production 
altan 		balcony 
altare 		altar 
alternativ 		alternative option 
altröst 		contralto contralto voice 
altstämma 		contralto contralto voice 
alun 		alum 
amatör 		amateur fancier 
ambition 		ambition 
ambitiös 		ambitious 
amerikan 		American 
amerikansk 		American 
amfiteatro 		amphitheatre 
amiral 		admiral 
ammunition 		munition ammunition 
amt 		district 
analogi 		analogy 
analys 		analysis 
anamma 		get have receive 
ananas 		pineapple 
anarkist 		anarchist 
anatomisk 		anatomical 
anbefalla 		commend recommend 
anbefallning 		recommendation 
anblick 		appearance aspect look sight view 
and 		duck 
anda 		spirit 
andas 		breathe 
ande 		mind 
andel 		part Parthian share 
andhämtning 		respiration 
andlig 		mental 
andlös 		breathless 
andning 		respiration 
andra 		second 
andre 		second 
anekdot 		anecdote 
anemi 		anaemia 
anfall 		access aggression attack 
anfalla 		assault attack 
anföra 		cite quote 
anförande 		citation quotation 
anförare 		boss chief leader 
anföringstecken 		inverted comma quotation mark quote 
anförvant 		relative 
angenäm 		agreeable enjoyable lovely nice pleasant 
angrepp 		access aggression attack 
angripare 		aggressor assailant attacker 
angående 		about concerning 
anhang 		adherents disciples following party supporters 
anhörig 		affined akin related 
anhålla 		arrest 
aning 		suspicion 
anis 		anise 
anka 		duck 
ankare 		anchor 
ankel 		ankle 
anklaga 		accuse 
anklagelse 		accusal accusation 
ankomst 		arrival 
anlete 		face 
anlopp 		crush 
anmoda 		ask ask for beg bid request 
anmodan 		request 
anmäla 		advertise announce give notice 
anmälan 		ad advertisement 
anmärkningsvärd 		noteworthy remarkable 
annalkande 		approach 
annan 		other another else 
annanstans 		elsewhere 
annons 		ad advertisement 
annonsera 		advertise announce give notice 
annorlunda 		differently else 
annorstädes 		elsewhere 
annotationsbok 		notebook 
annotera 		note make a note write down 
anonym 		anonymous 
anropa 		appeal to invoke 
ansa 		attend nurse tend to 
anse 		account deem opine think 
ansedd 		dear 
anseende 		appearance aspect look sight view 
ansikte 		face 
ansjovis 		anchovy 
anslag 		notice placard poster 
anslagstavia 		bill‐board notice‐board 
ansluta 		combine 
anslående 		agreeable enjoyable lovely nice pleasant 
anspela 		allude hint 
anspelning 		allusion 
anstöt 		offence scandal 
anstötlig 		aggravating 
anstånd 		adjournment delay 
ansvar 		responsibility 
ansvarig 		accountable responsible 
ansöka 		ask ask for beg bid request 
anta 		guess presume suppose surmise 
antagande 		suspicion 
antaglig 		suspicious 
antal 		amount number 
anteckna 		note make a note write down 
antikvitetshandlare 		antique dealer 
antända 		kindle light 
använda 		employ use make use of 
apa 		ape monkey 
apel 		apple‐tree 
apelsin 		orange 
apostel 		apostle 
apotek 		chemist's shop drugstore 
apotekare 		chemist 
apparat 		apparatus device set 
appell 		appeal 
applåd 		acclaim acclamation approval 
applådera 		acclaim applaud clap 
aprikos 		apricot 
april 		April 
apropå 		by the way 
aptit 		appetite 
arab 		Arab 
arabisk 		Arabian Arabic 
arbeställa 		abjure abolish abrogate annul cancel remit 
arbeta 		work 
arbetare 		hand laborer labourer operative worker working man workman 
arbete 		job work 
arbeterska 		female laborer femal labourer femal worker 
arbetsam 		diligent hardworking industrious 
arbetsgivare 		employer 
arbetslös 		unemployed 
arbetstagare 		employee 
areal 		area 
arg 		angry cross 
aritmetik 		arithmetic 
arkipelag 		archipelago 
arkitekt 		architect 
arkiv 		archive archives files records 
arkivarie 		archivist keeper of the records 
arm 		arm 
armband 		bracelet 
armbandsur 		watch wrist‐watch 
armbåge 		elbow 
armhåla 		armpit 
armod 		poverty 
armé 		army 
arrangera 		arrange fix up 
arrendator 		farmer 
arrende 		farm 
arrestera 		arrest 
art 		character nature personality 
artificiell 		artificial 
artig 		courteous polite well‐mannered 
artighet 		politeness 
artikel 		article commodity 
artilleri 		artillery 
artist 		artist 
arton 		eighteen 
artonde 		eighteenth 
artär 		artery 
arv 		inheritance 
arvinge 		heir 
arvode 		salary wage wages 
as 		cadaver corpse 
asiat 		Asian 
asiatisk 		Asian Asiatic 
ask 		ash 
aska 		ash cinder 
asketisk 		ascetic 
askkopp 		ashtray 
asp 		aspen 
assurans 		insurance 
aster 		aster 
astronomi 		astronomy 
ateism 		atheism 
ateist 		atheist 
ateljé 		atelier studio work‐room workshop 
atlas 		atlas 
atmosfär 		atmosphere 
atom 		atom 
atombomb 		atom bomb 
atomkraft 		atomic energy 
attack 		access aggression attack 
attest 		certificate testimony 
attestera 		attest bear witness of testify 
attraktion 		attraction 
auditorium 		auditory 
augusti 		August 
auktion 		auction 
auktor 		author 
australier 		Australian 
australisk 		Australian 
autentisk 		authentic 
automat 		automoton 
automatisk 		automatic 
av 		from of 
avbetala 		pay off 
avbetalning 		acquittal payment full payment 
avbryta 		interrupt 
avgiftsfri 		free 
avgrund 		abyss chasm gulf precipice 
avgränsa 		abridge confine limit restrict 
avgud 		idol 
avhämta 		fetch get pick up 
avhängig 		dependent 
avi 		ad advertisement 
avla 		cultivate grow 
avleverera 		deliver furnish supply 
avlida 		die expire pass away 
avliden 		dead 
avliva 		kill liquidate slay 
avlopp 		sewer 
avlöning 		salary wage wages 
avrätta 		kill liquidate slay 
avsked 		farewell goodbye good‐bye 
avskicka 		dismiss turn away 
avskrift 		copy 
avsky 		abhor abominate loathe 
avstånd 		distance offset 
avtagsväg 		by‐way side‐way 
avträde 		toilet 
avund 		envy 
avundas 		envy 
avundsam 		envious 
avväg 		by‐way side‐way 
avyttra 		dispose of sell vend 
av adel 		of noble birth 
av misstag 		by mistake 
av siden 		silk silk‐ silken of silk 
av trä 		wooden 
axel 		axis axle 
babian 		baboon 
babord 		port side 
baby 		baby 
backe 		hill 
bad 		bath 
baddräkt 		bathing suit bathing‐suit 
badhytt 		bathing box 
badkar 		bath 
badort 		spa 
badstuga 		sauna 
bagage 		baggage luggage 
bagagevagn 		luggage‐van 
bagarbod 		baker's shop 
bagare 		baker 
bageri 		bakery 
bagge 		ram tup 
bajersk 		Bavarian 
bajonett 		bayonet 
bajrare 		Bavarian 
bak 		back 
baka 		bake 
bakdanta 		slander 
bakefter 		behind 
baklykta 		rear‐lamp rear‐light tail‐light 
baktala 		slander 
bakterie 		bacterium 
baktill 		behind 
bakåt 		backward backwards 
bal 		ball dance 
balans 		equilibrium 
balett 		ballet 
balk 		beam girder 
balkong 		balcony 
ballast 		ballast 
ballong 		balloon 
balsam 		balm balsam 
baltisk 		Baltic 
balustrad 		balustrade banisters parapet railing 
bambu 		bamboo 
bana 		path road way 
banal 		commonplace dismal trite 
banan 		banana 
band 		band bevy gang 
bandage 		bandage 
bandit 		bandit 
baneman 		murderer 
bank 		bank 
banka 		beat hit strike 
bankett 		banquet 
bankir 		bank clerk bank official 
bankrutt 		bankruptcy failure 
bar 		bare naked nude 
bara 		exclusively just only 
barack 		barrack barn shack shanty shed 
barbar 		barbarian 
bark 		bark 
barlast 		ballast 
barnbarn 		grandchild 
barnlös 		childless 
barnmorska 		midwife obstetrician 
barnsängskvinna 		lying‐in woman 
barometer 		barometer 
baron 		baron 
baronessa 		baroness 
barrträd 		conifer 
basera 		base 
bassäng 		basin reservoir 
bast 		bast 
bastu 		sauna 
batalj 		action battle scuffle struggle 
bataljon 		battalion 
batteri 		accumulator battery storage battery 
beakta 		advert pay attention pay attention to watch out for 
bebåda 		advertise announce give notice 
bebådelsedag 		Annunciation Lady Day 
becksvart 		pitch black 
bedja 		ask ask for beg bid request 
bedra 		cheat deceive 
bedraga 		cheat deceive 
bedragare 		cheat deceiver imposter 
bedrägeri 		swindle 
bedräglig 		deceitful 
bedröva 		afflict cause pain cause pain to distress give pain to 
bedrövelse 		grief sadness sorrow 
bedöma 		judge 
befalla 		command be in command order 
befallning 		command 
befinna sig 		be found be located find oneself 
befolkning 		population 
befordra 		advance 
befordran 		advancement 
befria 		release 
befrämja 		favor favour 
befäl 		command 
befälhavare 		commander 
befängd 		foolish 
befästa 		attach determine fasten fix affix make fast secure 
begagna 		employ use make use of 
begagnande 		use 
begrava 		bury 
begravning 		burial funeral interment 
begrepp 		notion sense realization 
begripa 		understand realize 
begriplig 		understandable 
begrunda 		think think about reflect on 
begränsa 		abridge confine limit restrict 
begynna 		begin commence start 
begynnelse 		beginning commencement start 
begär 		avidity covetousness eagerness greediness 
begära 		covet 
begäran 		avidity covetousness eagerness greediness 
begärlig 		acquisitive eager greedy 
begåvning 		aptitude disposition talent 
behag 		pleasure 
behaga 		please 
behagfull 		charming lovely 
behaglig 		agreeable enjoyable lovely nice pleasant 
behandla 		deal with handle treat 
behandling 		treatment 
behjälplig 		accommodating helpful 
behjärtad 		brave courageous valiant 
behov 		need want 
behärska sig 		control oneself 
behöva 		need require 
behövande 		miserable poor 
behövlig 		necessary 
behå 		bra 
behåll 		safety security 
behålla 		conserve keep maintain preserve 
behållare 		tank 
bejaka 		affirm assent say yes 
bekant 		well‐known 
bekantgörande 		advice announcement communication message notice report 
beklaglig 		regrettable 
beklädnad 		clothes clothing 
bekomma 		get have receive 
bekosta 		bear the cost of defray the cost of pay the expenses of 
bekväm 		comfortable 
bekänna 		acknowledge admit confess profess 
bekännelse 		acknowledgement admission confession 
belgier 		Belgian 
belgisk 		Belgian 
belopp 		amount sum 
belysa 		illuminate light 
belysning 		lighting 
belägra 		besiege 
belägring 		siege 
belöna 		compensate reward 
belöning 		compensation reward 
belåten 		contented pleased satisfied 
bemärkelsedag 		meaning 
bemödande 		attempt effort 
ben 		leg 
benkläder 		pants trousers 
benrangel 		skeleton 
bensin 		gasolene gasoline petrol 
bensinstation 		filling station 
benämna 		call 
benåda 		forgive pardon 
benådning 		absolution pardon 
bepröva 		examine 
bereda 		prepare 
beredelse 		preparation 
berg 		mountain chain 
bergklyfta 		ravine 
bergskred 		avalanche 
berlinsk 		Berlin 
beroende 		dependent 
berudsad 		drunk intoxicated 
beryktad 		famous 
beräkna 		calculate count figure work out 
beräkning 		calculation computation 
berätta 		narrate relate tell 
berättelse 		account narrative story tale 
beröm 		praise 
berömd 		famous 
berömlig 		commendable 
berömma 		commend laud praise 
beröra 		touch 
beröring 		touch 
besegra 		defeat win over 
besegrare 		victor 
besiktiga 		inspect 
besiktningsman 		inspector 
besinna 		think think about reflect on 
besittning 		property 
besk 		acerbic bitter 
besked 		answer reply 
beskriva 		describe 
beskrivning 		account description 
beskydd 		protection 
beskydda 		protect 
beskyddare 		patron 
beskylla 		accuse 
beskyllning 		accusal accusation 
beskärm 		protection 
besluta 		decide 
besläktad 		affined akin related 
best 		animal beast 
bestjäla 		rob 
bestraffa 		punish 
besvikelse 		disappointment 
besättning 		crew 
besök 		visit 
besökande 		caller visitor 
betala 		pay 
betalning 		payment 
betalningsbevis 		receipt 
beteckna 		imply mean signify 
beteende 		behavior behaviour conduct deportment 
bete sig 		behave conduct oneself 
betjäningsavgift 		tip 
betjänt 		boy servant 
betong 		concrete 
betrakta 		account consider esteem regard take into account 
betrygga 		affirm assure 
beträffa 		concern 
bett 		teeth 
betyda 		imply mean signify 
betydelse 		meaning 
betyga 		attest bear witness of testify 
betäcka 		cover 
betänka 		think think about reflect on 
beundra 		admire 
beundran 		admiration 
beundrare 		admirer 
bevis 		proof sign token 
bevisa 		prove 
bevista 		attend be present witness 
beväpna 		arm 
be om ursäkt 		ask forgiveness excuse oneself 
bi 		bee 
bibel 		bible 
bibliotek 		library 
bibliotekarie 		librarian 
bifall 		acclaim acclamation approval 
biff 		steak beefsteak 
biffstek 		steak beefsteak 
bifoga 		add 
bikt 		confession 
bikta 		confess 
bikupa 		beehive 
bil 		car 
bila 		axe 
bild 		image picture 
bilda 		form shape 
bildhuggare 		sculptor 
bildstod 		statue 
bilist 		motorist 
biljard 		billiards 
biljett 		bill ticket note 
billig 		cheap inexpensive 
billyftare 		jack 
binamn 		byname nickname sobriquet 
binda 		bind 
biodlare 		apiarist bee‐keeper bee‐master 
biograf 		cinema movie theatre 
biskop 		bishop 
bistånd 		aid help 
bit 		bit lump piece 
bita 		bite 
biträda 		accomodate aid assist help 
biträde 		aid help 
bitter 		acerbic bitter 
bittida 		early 
bjuda 		invite 
bjudning 		invitation 
bjälke 		beam girder 
björk 		birch 
björn 		bear 
björnbär 		blackberry 
björnhona 		she‐bear 
björninna 		she‐bear 
blad 		leaf sheet 
blanda 		blend mingle mix shuffle 
bli 		become come about grow happen 
blid 		advantageous favourable 
blind 		blind 
bliva 		become get grow 
blixt 		lightning 
blixtlås 		zipper 
blixttåg 		fast train 
bli förälskad i 		fall in love with 
bli kär i 		fall in love with 
block 		block pad 
blockad 		blockade 
blockera 		block blockade 
blod 		blood 
blodbrist 		anaemia 
blodigel 		leech 
blodsfrånde 		relative 
blodsförvant 		relative 
blomkål 		cauliflower 
blomma 		bloom flower 
blomster 		bloom flower 
blond 		blond fair 
bloss 		torch 
blott 		exclusively just only 
blus 		blouse 
bly 		lead 
blyertspenna 		pencil 
blyg 		abashed self‐conscious shy 
blygas 		be ashamed 
blyghet 		bashfulness shyness timidity 
blygsam 		modest 
blygsel 		shame 
bläck 		ink 
bläckhorn 		well inkpot ink‐well 
bläddra 		bladder bubble 
blända 		dazzle 
blöda 		bleed 
blå 		blue 
blåbär 		blueberry 
blåklint 		cornflower 
blåsa 		blow 
bo 		dwell live 
bobba 		cockroach 
bock 		he‐goat 
boddisk 		counter 
bohag 		furniture 
bok 		beech 
bokförare 		book‐keeper 
bokhandlare 		bookseller 
bokhållare 		book‐keeper 
bokskåp 		bookcase 
bokslut 		balance sheet 
bokstav 		letter 
boll 		ball 
bom 		barrier fence 
bomb 		bomb 
bomull 		cotton 
bonde 		farmer 
bondgård 		estate farm property ranch 
boning 		abode accommodation dwelling residence 
bord 		table 
bordduk 		table‐cloth 
bordell 		brothel 
borg 		castle 
borgmästare 		mayor 
borr 		bore 
borra 		bore drill 
borsta 		brush 
borste 		brush 
bostad 		abode accommodation dwelling residence 
botanik 		botany 
botten 		bottom foundation ground 
bottenvåning 		ground‐floor 
boxa 		box 
bo ihop 		cohabit live together 
bra 		good nice okay 
brasiliansk 		Brazilian 
braxen 		bream 
bredd 		width 
bredvid 		beside alongside next to 
brev 		letter 
brevbärare 		postman 
brevkort 		postcard 
brevlåda 		letterbox mailbox 
brigad 		brigade 
brinna 		burn 
bris 		breeze 
brist 		absence lack shortage shortcoming 
britt 		Briton 
brittisk 		British 
bro 		bridge 
broder 		brother 
broms 		brake 
bromsa 		brake 
brons 		bronze 
bror 		brother 
brorsdotter 		niece 
brorson 		nephew 
brorsson 		nephew 
brosch 		brooch 
broschyr 		leaflet pamphlet paperback 
brottslig 		criminal 
brottsling 		criminal 
brud 		bride 
brudgum 		bridegroom 
bruk 		use 
bruka 		employ use make use of 
bruklig 		accustomed customary used to usual wonted 
brun 		brown 
brunn 		spa 
brydd 		abashed self‐conscious shy 
bryderi 		bashfulness shyness timidity 
brysselkål 		Brussels‐sprouts 
bryta 		break 
brytbar 		breakable brittle fragile 
bräcklig 		breakable brittle fragile 
bräde 		board plank 
brännmaterial 		fuel 
brännvin 		brandy 
brännässla 		nettle 
bränsle 		fuel 
bröd 		bread loaf 
bröllop 		wedding wedding‐feast wedding‐party 
bröst 		bosom breast chest 
bråk 		ado din noise 
buffel 		buffalo 
buk 		abdomen belly tummy 
bulevard 		boulevard 
buljong 		bouillon 
bulle 		roll 
buller 		ado din noise 
bulletin 		bulletin 
bullra 		make a noise 
bur 		cage 
buske 		bush shrub 
buss 		friend 
butelj 		bottle 
butik 		boutique shop store 
butiksinnehavare 		shopkeeper 
by 		village 
bygdemål 		dialect 
bygga 		build construct 
byggmästare 		architect 
byggnad 		building 
byggnadstomt 		building‐plot building‐site 
byrå 		office 
bytta 		bucket pail 
byx 		pants trousers 
byxa 		pants trousers 
byxor 		pants trousers 
bäck 		stream 
bädd 		bed 
bägare 		goblet 
bägge 		both 
bälte 		belt girdle 
bänk 		bench 
bär 		berry 
bära 		carry wear 
bärare 		porter 
bäst 		best 
bättra 		improve 
bättre 		better 
bäva 		quiver shiver tremble 
bäver 		beaver 
bödel 		hangman executioner 
bölja 		undulate 
bön 		request 
böna 		bean 
böra 		have to must ought to should 
börd 		birth 
börja 		begin commence start 
början 		beginning commencement start 
börs 		stock exchange 
böter 		fine 
båda 		both 
båge 		arc bow 
båt 		boat 
båtledes 		by ship 
ceder 		cedar 
cedere 		cede give in give up give way relinquish yield 
cell 		cell 
cement 		cement 
censur 		censor 
censurera 		censor 
center 		centre 
centimeter 		centimetre 
central 		central 
ceremoni 		ceremony 
ceremoniell 		formal measured stiff 
cession 		bankruptcy failure 
champagne 		champagne 
champignon 		mushroom 
chaufför 		chauffeur driver 
check 		check cheque 
checkbok 		cheque‐book 
chef 		boss chief leader 
choklad 		chocolate 
cigarr 		cigar 
cigarrett 		cigarette 
cirka 		about approximately 
cirkel 		circle 
cirkus 		circus 
citat 		citation quotation 
citera 		cite quote 
citron 		lemon 
civilstånd 		civil status 
cykel 		bike cycle bicycle 
cyklon 		cyclone 
cylinder 		cylinder roller 
cynisk 		cynical 
cypress 		cypres 
dadel 		date 
dadelpalm 		date palm date‐palm 
dag 		day 
dagblad 		daily paper journal newspaper 
dagg 		dew 
dagning 		dawn daybreak 
dagsböter 		fine 
dal 		valley 
dala 		ascend climb go up 
dallra 		quiver shiver tremble 
dam 		lady 
damm 		dike embankment 
dammsugare 		vacuum cleaner vacuum‐cleaner 
dana 		form shape 
dans 		dance 
dansa 		dance 
dansk 		Danish 
dansös 		dancer 
darra 		quiver shiver tremble 
datamaskin 		computer 
datera 		date 
dator 		computer 
datum 		date 
december 		December 
deg 		dough paste 
dekan 		blanket 
deklamera 		declaim recite 
dekret 		decree 
del 		part Parthian share 
dela 		divide separate share 
delta 		delta 
dentist 		dentist 
departementschef 		minister 
deponera 		deposit 
deprimerad 		depressed 
desinficera 		disinfect 
desperat 		desperate 
despotisk 		despotic 
desslikes 		still yet 
destillera 		distil 
detalj 		detail 
detektiv 		detective 
det var synd 		alas regrettably unfortunately 
devis 		motto watchword slogan 
dialekt 		dialect 
diamant 		diamond 
diarium 		diary 
diarré 		diarrhoea 
diet 		diet 
diger 		bold corpulent fat thick 
dikt 		poem 
diktare 		poet 
diktera 		dictate 
dimma 		fog mist 
dimmig 		fuzzy misty 
diplom 		diploma 
direktion 		direction 
direktör 		director manager 
disciplin 		discipline 
disig 		fuzzy misty 
diskont 		discount 
diskret 		discrete 
diskutera 		discuss 
distans 		distance offset 
distrikt 		district 
dit 		that way there thither yonder 
djup 		deep profound 
djuphet 		depth 
djuplek 		depth 
djur 		animal 
djurisk 		animal 
djävul 		devil 
docka 		doll puppet 
doft 		odor odour scent smell 
dofta 		give off an odour reek smell 
dogm 		dogma 
dok 		veil 
doktor 		doctor physician 
dokument 		document paper 
dold 		hidden 
dolk 		dagger 
dolsk 		false 
dom 		judgment 
domare 		judge 
dop 		baptism christening 
dosa 		box 
dotter 		daughter 
dotterdotter 		granddaughter 
dotterson 		grandson 
dra 		drag draw haul pull tug 
drabba 		beat hit strike 
draga 		drag draw haul pull tug 
drake 		dragon 
dram 		drama 
drama 		drama 
dregel 		saliva 
dregla 		salivate 
dricks 		tip 
drickspengar 		tip 
drink 		cocktail 
drinkare 		boozer alcoholic 
driva 		chase drive drive on impel shoo 
dromedar 		dromedary 
droppa 		drip 
droppe 		drip drop 
droskbil 		taxi 
drottning 		queen 
drucken 		drunk intoxicated 
drukna 		drown 
druva 		grape 
dryck 		beverage drink 
dryckenskap 		drunkenness inebriety 
dräktig 		pregnant with young 
dräng 		boy servant 
dränka 		drown 
dräpa 		kill liquidate slay 
dröm 		dream 
drömma 		dream 
dråp 		murder 
dråpare 		murderer 
dubbel 		double dual 
dubblera 		double 
duk 		table‐cloth 
dum 		addled foolish stupid 
dumbom 		fool 
dumhuvud 		fool 
dunkelhet 		darkness murk 
dunst 		steam vapor vapour 
dunstkrets 		atmosphere 
duo 		pair 
dusch 		shower 
duscha 		shower 
dussin 		dozen 
duva 		dove pigeon 
dvärg 		dwarf midget 
dy 		mud 
dyka 		dive plunge 
dyna 		cushion 
dynamit 		dynamite 
dynga 		fertilizer manure 
dyr 		dear expensive valuable 
dyrbar 		dear expensive valuable 
däld 		valley 
dö 		die expire pass away 
död 		dead 
dödlig 		deadly 
döma 		judge 
döpa 		baptize christen 
döpelse 		baptism christening 
dörr 		door 
dörvakt 		porter 
dörvaktare 		porter 
döv 		deaf 
dövstum 		deaf and dumb 
dåd 		accomplishment achievement act action 
dålig 		bad miserable nasty poor 
dån 		ado din noise 
dåraktig 		crazy insane mad nuts 
dåre 		lunatic 
ebb 		low tide 
ed 		oath 
effekt 		effect 
efter 		from since 
efterbilda 		imitate 
eftermiddag 		afternoon 
efternamn 		surname 
efterrätt 		dessert 
egendom 		possession property 
egendomlig 		odd peculiar strange 
egenskap 		property quality 
ehuru 		though although 
ehuruväl 		though although 
ej 		not 
ek 		oak 
eko 		echo 
ekollon 		acorn 
ekonomi 		economy 
ekorre 		squirrel 
ekvator 		equator 
elastisk 		elastic 
eld 		fire 
elefant 		elephant 
elektricitet 		electricity 
elektrisk 		electric 
element 		element 
elementär 		elemental elementary 
elfenben 		ivory 
elfte 		eleventh 
elva 		eleven 
emblem 		emblem 
emellan 		among between 
emellanåt 		several times sometimes 
emma 		armchair 
emot 		across from against in exchange for opposed to opposite upon 
en 		one 
ena 		join unite 
encyklopedi 		encyclopaedia 
endast 		exclusively just only 
energi 		energy 
engagera 		employ hire 
engelsk 		English 
engelsman 		Englishman Sassenach 
enhet 		unity 
enplansvilla 		bungalow 
ensam 		alone only sole solitary 
ensamstående 		living alone single 
entonig 		monotonous 
entré 		access admission admittance 
entusiasm 		alacrity enthusiasm 
episod 		episode 
epok 		age epoch era 
era 		era 
erkänna 		acknowledge recognize 
erlägga 		pay 
ernå 		accomplish achieve attain get reach 
erövra 		conquer 
eskimå 		Eskimo 
eskort 		escort 
etisk 		ethical 
ett 		one 
ettrig 		poisonous 
ett hundra 		hundred one hundred 
ett tusen 		thousand one thousand 
eunuck 		eunuch 
europeisk 		European 
europé 		European 
examen 		investigation examination test 
exempel 		example 
exemplar 		copy 
existens 		existence 
explikation 		account explanation 
explodera 		explode 
exponera 		exhibit 
exposition 		exhibition exposition 
extas 		ecstasy 
extra 		additional extra 
fabrik 		factory 
fack 		branch compartment department pigeonhole section speciality 
fackla 		torch 
fader 		father 
faderlös 		fatherless 
faktisk 		actual factual real 
faktum 		fact 
faktura 		account bill invoice 
fakultet 		faculty 
falk 		falcon 
falla 		drop fall 
fallissemang 		bankruptcy failure 
fallskärm 		parachute 
falsk 		false 
familj 		family 
famna 		embrace 
fan 		devil 
fanatisk 		fanatical 
fantasi 		fantasy 
far 		father 
fara 		danger peril 
farbroder 		uncle 
farbror 		uncle 
farfader 		grandfather 
farfar 		grandfather 
farföräldrar 		grandparents 
farlig 		dangerous 
farmor 		grandmother 
fars 		gag joke 
fart 		speed 
fartyg 		ship vessel 
fasad 		façade 
fasan 		pheasant 
faster 		aunt 
fastland 		continent mainland 
fastän 		though although 
fat 		barrel 
fatta 		get lay hold of pick up take 
fattig 		miserable poor 
fattigdom 		poverty 
fattlig 		understandable 
feber 		ague fever 
februar 		February 
fel 		aberration error mistake 
fela 		err make a mistake 
fem 		five 
femte 		fifth 
femti 		fifty 
femtio 		fifty 
femton 		fifteen 
femtonde 		fifteenth 
fena 		fin 
fenomen 		phenomenon 
ferier 		vacation 
fernissa 		varnish 
fest 		celebration festival party 
festa 		celebrate 
fet 		bold corpulent fat thick 
fett 		fat grease 
fiber 		fiber fibre 
ficka 		pocket 
fickkniv 		pen‐knife 
fiende 		adversary enemy 
fiendskap 		enmity 
fientlig 		adverse hostile 
fiffig 		clever cunning sly smart 
figur 		figure diagram image picture representation 
fikon 		fig 
fil 		file 
fila 		file 
filosof 		philosopher 
filt 		felt 
filtrera 		filter 
finansiell 		financial 
finger 		finger 
finna 		find 
finne 		Finn 
finsk 		Finnish 
fira födelsedagen 		celebrating one's birthday 
fisk 		fish 
fiska 		fish 
fiskare 		fisherman 
fiskmås 		seagull 
fiskmåse 		seagull 
fjord 		fjord inlet loch 
fjorton 		fourteen 
fjortonde 		fourteenth 
fjäder 		feather 
fjäll 		scale 
fjärde 		fourth 
fjäril 		butterfly 
flack 		even flat level smooth 
flagg 		banner flag 
flagga 		banner flag 
flamländare 		Flemming 
flamma 		flame 
flanell 		flannel 
flank 		side 
flaska 		bottle 
flicka 		mend patch patch up 
flod 		high tide 
flodhäst 		hippo hippopotamus 
flotta 		fleet 
flotte 		raft 
fluga 		fly housefly 
fly 		flee run away 
flyga 		fly 
flygfält 		aerodrome airdrome airfield 
flyghamn 		airport 
flygmaskin 		aeroplane airplane plane 
flygplan 		aircraft 
flykt 		flight 
flyta 		float 
flytande 		fluent 
flytta 		move 
flyttbil 		furniture van pantechnicon pantechnicon van 
flyttning 		removal move 
fläck 		blot spot 
fläder 		elder 
flädermus 		bat 
fläkta 		blow 
fläsk 		bacon 
flöde 		river 
flöjt 		flute 
folk 		folk nation people 
folkmål 		dialect 
folkvälde 		democracy 
fond 		fund 
fontän 		fountain 
fordon 		vehicle 
forell 		trout 
forma 		form shape 
formel 		formula 
formell 		formal 
formera 		form shape 
formulär 		blank form 
forsla 		transport 
forvänta 		abide expect wait await wait for 
fosfor 		phosphorus 
fotfolk 		infantry 
fotgängare 		pedestrian 
fotogen 		paraffin‐oil petroleum 
fotograf 		photographer 
fotografera 		photograph 
fotografi 		photography 
fotografiapparat 		camera 
fotsula 		sole 
fradga 		foam froth 
frakt 		burden charge load 
frakta 		transport 
framgång 		achievement success 
framtid 		future 
frans 		frindge 
fransk 		French 
franska 		French French language 
fransman 		Frenchman 
fransyska 		Frenchwoman 
fred 		peace 
freda 		protect 
fredag 		Friday 
frejdad 		famous 
fria 		release 
friherre 		baron 
frihet 		freedom 
frimurare 		freemason Mason 
frimärke 		stamp postage stamp 
fris 		Frisian 
fristående 		detached free‐standing 
fristående hus 		detached house 
frisör 		barber hairdresser 
frost 		freezing cold frost 
fru 		lady 
frukt 		fruit 
fruktan 		agony anguish fear 
fruktbar 		fertile 
fruktträd 		fruit‐tree 
frysa 		freeze 
fräck 		impertinent 
frälsningsamé 		Salvation Army 
främling 		foreigner stranger 
främmande 		alien foreign 
frände 		relative 
frö 		seed 
fröjd 		fun pleasure 
fröjda 		be glad enjoy rejoice 
fråga 		ask 
frågvis 		agog inquisitive 
från 		from out of 
frånskild 		divorced 
frånvarande 		absent 
frånvaro 		absence non‐attendance 
fråvarande 		absent 
fuktig 		moist 
ful 		nasty ugly 
full 		drunk intoxicated 
fullborda 		accomodate end finish terminate 
fullvuxen 		adult full‐grown 
fur 		pine pine‐tree 
fura 		pine pine‐tree 
furste 		prince 
furstendöme 		principality 
furstinna 		princess 
furstlig 		regal royal 
fylla 		fill fill in fill up 
fylla år 		celebrating one's birthday 
fyr 		lighthouse 
fyra 		four 
fyrhörning 		quadrangle 
fyrsprång 		gallop 
fyrti 		forty 
fyrtio 		forty 
fyrtorn 		lighthouse 
fysik 		physics 
fädernesland 		fatherland 
fällkniv 		pen‐knife 
fält 		field 
fältflaska 		canteen water‐bottle 
fängelse 		jail gaol prison 
färd 		journey trip voyage 
färdas 		travel 
färdig 		finished ready through 
färg 		dye paint 
färga 		paint 
färglös 		achromatic 
färja 		ferry 
fästa 		attach determine fasten fix affix make fast secure 
fästman 		fiancé 
fästmö 		bride fiancée 
födelse 		birth 
födelsedag 		birthday 
födelseort 		cradle place of birth 
följa 		follow 
fönster 		window 
för 		for to in order to per 
föra 		conduct guide lead 
förakt 		contempt 
förakta 		despise 
föranleda 		activate cause give rise to 
förarga 		aggravate annoy 
förargelse 		offence scandal 
förband 		bandage 
förbanna 		curse 
förbereda 		prepare 
förberedelse 		preparation 
förbli 		remain stay stay over 
förblinda 		dazzle 
förbliva 		remain stay stay over 
förblända 		dazzle 
förbruka 		use up 
förbrytare 		criminal 
förbrytelse 		crime 
förbränna 		burn down 
fördel 		advantage benefit 
fördelaktig 		advantageous 
fördom 		prejudice 
fördubbla 		double 
fördämning 		dike embankment 
fördölja 		conceal hide 
fördöma 		curse 
förebild 		example 
förebrå 		blame rebuke reproach reprove scold 
förebråelse 		reproach 
föredöme 		example 
förenkla 		simplify 
förevita 		blame rebuke reproach reprove scold 
förevändning 		pretext 
författare 		author 
förfäringssätt 		procedure process 
förfärlig 		alarmed dismayed dumbfounded put out of countenance 
förfölja 		chase persecute prosecute pursue 
förföljande 		persecution pursuit 
förföljelse 		persecution pursuit 
förföra 		entice seduce 
förförelse 		temptation 
förgasare 		carburettor 
förgifta 		poison 
förgätmigej 		forget‐me‐not 
förgäves 		in vain 
förgången 		last 
förgås 		perish 
förhindra 		bar inhibit prevent 
förhoppning 		hope 
förhänge 		curtain 
förhållande 		relation 
förinta 		destroy quash 
förjaga 		chase away drive away expel 
förklara 		declare state 
förklaring 		declaration proclamation statement 
förklarlig 		accountable 
förkylning 		cold 
förlama 		paralyse 
förleda 		entice seduce 
förlora 		lose 
förlova sig 		become engaged 
förlova sig med 		become engaged with become the fiacée of 
förlovning 		betrothal engagement 
förlust 		loss 
förlägen 		abashed self‐conscious shy 
förlägenhet 		bashfulness shyness timidity 
förläggare 		publisher 
förlänga 		lengthen 
förlåt 		excuse me 
förlåta 		forgive pardon 
förlåtelse 		absolution pardon 
förnamn 		first name 
förnedra 		abase 
förneka 		deny 
förnärma 		abuse insult offend 
förnärmelse 		abuse 
förnödenhet 		need want 
förolämpning 		abuse 
förord 		recommendation 
förorda 		commend recommend 
förorena 		soil 
förorsaka 		activate cause give rise to 
förort 		suburb 
förpakta 		farm out 
förplikta 		compel force 
förryckt 		crazy insane mad nuts 
förrädisk 		treacherous 
förrän 		before in front of 
förråda 		betray 
församla 		collect gather pick up 
församling 		assemblage gathering meeting 
försiktig 		careful cautious 
förskräcklig 		abysmal dreadful gruesome horrible terrible 
förslag 		account record report 
första 		first 
förstad 		suburb 
förstora 		aggrandize augment enlarge increase 
förstöra 		destroy quash 
försvar 		defence defense 
försvara 		defend 
försvinna 		disappear 
försäkra 		insure 
försäkring 		insurance 
försälja 		dispose of sell vend 
försäljning 		sale 
försämra 		blow up heighten 
försök 		experiment 
försöka 		attempt test try 
förtal 		backbiting scandal slander 
förtala 		slander 
förtjäna 		earn gain win 
förtretlig 		bleak dismal dreary horrible ghastly grisly nasty 
förtroende 		confidence faith trust 
förtrytelse 		offence scandal 
förtvivlad 		desperate 
förtvivlan 		despair 
förundran 		astonishment wonder surprise 
förutan 		without 
förvalta 		administer manage 
förvaltare 		manager 
förvandla 		alter change 
förvara 		conserve keep maintain preserve 
förvaringsställe 		box‐room storage room 
förvillelse 		aberration error mistake 
förväntan 		expectation 
förvärra 		blow up heighten 
förvärv 		accession acquisition gain 
förvärva 		achieve acquire attain get obtain 
förväxla 		change turn 
förvåna 		amaze 
förvåna sig 		marvel marvel at wonder 
förvåning 		astonishment wonder surprise 
föräldrar 		parents 
förälska sig i 		fall in love with 
förändra 		change turn 
förändras 		alter change 
förändring 		about‐face alteration change conversion transformation 
förära 		adore worship 
förödmjuka 		abase 
förödmjukelse 		abasement 
förölämpa 		abuse insult offend 
fösa 		chase drive drive on impel shoo 
få 		get have receive 
fågel 		bird 
fåne 		idiot 
fånga 		capture catch grapple 
fångst 		prey 
får 		sheep 
fårkött 		mutton 
gadd 		sting 
gaffel 		fork 
gagn 		advantage benefit 
gagna 		avail 
galen 		crazy insane mad nuts 
galenskap 		craziness insanity lunacy madness 
galla 		bile gall 
galleri 		gallery 
galning 		lunatic 
galopp 		gallop 
galosch 		galosh overshoe 
gam 		vulture 
gammal 		old 
gammaldags 		old‐fashioned out of date 
gammalmodig 		old‐fashioned out of date 
gap 		abyss chasm gulf precipice 
gapa 		gape gawk 
gapskratta 		roar with laughter 
garantera 		guarantee warrant 
garde 		guard 
garderob 		cloakroom 
garn 		thread 
garnison 		garrison 
gas 		gas 
gasell 		gazelle 
gast 		ghost phantom 
gastrampa 		accelerator accelerator pedal 
gata 		street 
ge 		give 
gebit 		region 
gedigen 		pure 
gemak 		chamber room 
gemen 		accustomed customary used to usual wonted 
gemenligen 		ordinarily usually 
gemensam 		common joint 
gemenskap 		community 
gen 		short 
general 		general 
genever 		gin 
genklang 		echo 
genljud 		echo 
genljuda 		echo 
genmäle 		answer reply 
genom 		through 
genomtrött 		exhausted tired out worn out 
gensvarig 		rude 
geografi 		geography 
geologisk 		geological 
geometri 		geometry 
germansk 		Germanic Teutonic 
gest 		gesture 
gestalt 		figure diagram image picture representation 
get 		she‐goat 
geting 		wasp 
gevär 		gun rifle 
ge sig iväg 		absent onself depart go away leave 
gid 		handbook guide guidebook 
gift 		married 
gifta sig 		marry be married get married 
gifta sig med 		become the wife of marry 
giftig 		poisonous 
gift par 		couple married people 
gikt 		arthritis 
ginst 		greenweed 
giraff 		giraffe 
girig 		avaricious miserly stingy 
girland 		garland wreath 
gissa 		guess 
gisslan 		hostage 
gitarr 		guitar 
gitta 		be able to 
giva 		give 
givande 		fertile 
given 		certain sure 
givmild 		generous 
gjuta 		pour scatter shed 
glad 		cheerful gay merry 
gladlynt 		cheerful gay merry 
glansslipa 		polish 
glas 		glass 
glass 		ice icecream 
glasyr 		glaze 
glasögon 		glasses spectacles 
glatt 		smooth 
gles 		airy 
glida 		glide slip 
glob 		ball ball‐bearing globe 
glugg 		hole 
glöd 		glow heat passion 
glöda 		glow glow with heat 
glömma 		forget 
glömsk 		forgetful 
glåmig 		pale sallow 
gnaga 		gnaw 
gnida 		rub 
gnidare 		miser niggard skinflint 
gnista 		spark 
gno 		rub 
gnugga 		rub 
gnägga 		neigh 
god 		good nice okay 
goddag 		good afternoon 
godhet 		goodness 
godhjärtad 		good‐hearted kind 
godkänna 		approve 
godkännande 		acclaim approval 
godmodig 		good‐hearted kind 
godvillig 		voluntary 
god afton 		good evening 
god kväll 		good evening 
god morgon 		good morning 
golv 		floor 
gosse 		boy lad laddie 
grad 		degree grade 
graf 		grave tomb 
gram 		gram gramme 
grammatik 		grammar 
grammatika 		grammar 
gran 		fir 
granat 		grenade 
granit 		granite 
granne 		neighbour 
gratis 		free 
gratulera 		congratulate 
grav 		pole 
gravitation 		mortgage 
grek 		Greek 
grekinna 		Greek woman 
grekisk 		Greek 
gren 		bough branch 
grep 		fork 
greve 		count earl 
grina 		cry weep 
gris 		hog pig swine 
gro 		accrue grow 
groda 		frog 
grotta 		cave grotto 
grubbla 		puzzle over rack one's brains 
grund 		bottom foundation ground 
grunda 		erect establish found 
grupp 		group 
gruva 		mine 
gruvarbetare 		miner 
gruvlig 		agonizing hideous horrible ghastly 
grym 		cruel 
gräl 		quarrel 
gräla 		quarrel wrangle 
grämelse 		sadness sorrow 
gränd 		alley lane 
gräns 		boundary frontier limit 
gränslös 		absolute 
gräs 		grass 
gräshoppa 		grasshopper locust 
gräslig 		abysmal dreadful gruesome horrible terrible 
gräslök 		chive 
gräsmatta 		lawn 
gräva 		dig grub spade 
grävling 		badger 
grävsvin 		badger 
gröda 		harvest 
grön 		green 
grönsaker 		vegetable 
grå 		grey 
gråsparv 		sparrow 
gråta 		cry weep 
gud 		god 
gudlig 		pious 
gudomlig 		divine 
gudsförmädelse 		blasphemy 
gudsförnekare 		atheist 
gul 		yellow 
guld 		gold 
guldfisk 		goldfish 
guldgruva 		gold‐mine 
guldsmed 		goldsmith 
gummi 		rubber 
gumse 		ram tup 
gunst 		favor favour 
gunstig 		advantageous favourable 
gurka 		gherkin 
gutår 		cheers good health 
gymnasium 		high school 
gymnastik 		gymnastics 
gynna 		advance 
gynnsam 		advantageous favourable 
gyttja 		mud 
gädda 		pike 
gäl 		gill 
gälla 		be worth 
gärd 		proof sign token 
gärna 		voluntary willing 
gärning 		achievement act action 
gäspa 		gape gawk 
gäst 		guest 
gästfri 		hospitable 
gästgivargård 		hostel inn 
gästvänlig 		hospitable 
gästvänskap 		hospitality 
gök 		cuckoo 
gömma 		conceal hide 
göra 		achieve act do make perform 
göra bekantskap med 		make ... acquaintance 
göra besviken 		disappoint 
göra konkurs 		be bankrupt go broke 
gördel 		belt girdle 
görlig 		achievable 
gå 		go 
gång 		occasion time 
gångbana 		pavement sidewalk 
gångbar 		passable practicable 
gångjärn 		hinge 
gård 		estate farm property ranch 
gårdstomt 		court yard courtyard 
gås 		goose 
gåta 		enigma puzzle riddle 
gåva 		gift present 
ha 		have have got 
hackspett 		woodpecker 
hagel 		hail 
haj 		shark 
haka 		chin 
hake 		hook 
hal 		slippery 
hala 		fetch get pick up 
halkig 		slippery 
hall 		hall 
hallon 		raspberry 
halm 		straw 
hals 		neck 
halsband 		necklace 
halstra 		roast toast 
halta 		limp 
halv 		half 
halvdager 		dusk 
halvklot 		hemisphere 
halvö 		peninsula 
hammare 		hammer 
hamn 		harbor harbour port 
hampa 		hemp 
hamra 		hammer 
han 		he him 
hand 		hand 
handel 		business commerce trade 
handelsbod 		boutique shop store 
handelsman 		merchant 
handla 		do business trade 
handled 		wrist 
handling 		achievement act action 
handlov 		wrist 
handlove 		wrist 
handske 		glove mitten 
handväska 		hand‐bag 
hans 		his 
hare 		hare 
harem 		harem 
harm 		offence scandal 
harmas 		be indignant 
harmlig 		indignant 
harmoni 		harmony 
harmoniera 		accord fit together harmonize 
harmonika 		harmonica 
harpa 		harp 
hart 		quite very very much 
harva 		harrow 
hassel 		hazel hazel‐tree 
hasselnöt 		hazelnut 
hast 		haste 
hastig 		hurried 
hastighet 		speed 
hastighetsgräns 		speed‐limit speed limit 
hat 		hate 
hata 		hate 
hatt 		hat 
hav 		sea 
hava 		have have got 
havande 		pregnant 
haveri 		damage 
havre 		oats 
ha ett förhållande med 		associate with 
ha fest 		celebrate 
ha födelsedag 		celebrating one's birthday 
ha förtroende för 		have faith have faith in trust 
ha medlidande 		have compassion on pity 
ha medlidande med 		have compassion on pity 
ha otur 		have bad luck 
ha respekt för 		respect 
ha tur 		be lucky have good luck 
hed 		heath 
heder 		honor honour 
hederlig 		honorary 
hedning 		pagan 
hednisk 		pagan 
hedra 		honor honour 
hej 		hello 
hejdlös 		absolute 
hejsan 		hello 
hej då 		adieu farewell bye goodbye 
hej så länge 		bye goodbye so long 
hektoliter 		hectolitre 
hel 		entire overall whole 
hela 		cure heal remedy 
helgedom 		sanctuary sanctum 
helgon 		saint 
helig 		holy sacred 
hellre 		preferably rather 
helvete 		hell 
hem 		home 
hemgift 		dowry 
hemland 		fatherland 
hemlig 		secret 
hemma 		at home 
hemsk 		alarmed dismayed dumbfounded put out of countenance 
hemtrevlig 		homy 
hemåt 		home 
hennes 		her 
herr 		Mister Mr. sir 
herre 		gentleman lord 
herrskap 		ladies and gentlemen Mr. and Mrs. 
hertig 		duke 
hertigdöme 		duchy 
hertiginna 		duchess 
hes 		hoarse 
het 		hot 
heta 		call 
hetta 		heat 
hicka 		hiccup 
himlakropp 		heavenly body 
himmel 		heaven sky 
himmelsk 		celestial heavenly 
hind 		doe hind 
hinder 		obstacle 
hindra 		bar inhibit prevent 
hingst 		stallion 
hink 		bucket pail 
hisklig 		agonizing hideous horrible ghastly 
hiss 		elevator lift 
hissa 		lever lift raise 
historia 		story history 
historiett 		anecdote 
hit 		here hither this way 
hitta 		find 
hjort 		deer 
hjul 		wheel 
hjulaxel 		axis axle 
hjälm 		helmet 
hjälp 		aid help 
hjälpa 		accomodate aid assist help 
hjälpare 		aid assistent helper 
hjälplös 		helpless 
hjälte 		hero 
hjältemodig 		heroic 
hjältinna 		heroine 
hjärna 		brain 
hjärta 		heart 
hjärtlig 		hearty cordial warm 
hjässa 		skull 
hojta 		cry out scream shout 
holländare 		Dutchman Hollander 
holländsk 		Dutch 
hon 		her she 
honnör 		honor honour 
honorar 		fee 
honung 		honey 
hop 		accumulation crowd heap mass multitude pile 
hopp 		hope 
hoppa 		jump leap spring 
hoppas 		hope 
hopplös 		abysmal desperate 
hora 		hooker whore 
horisont 		horizon 
horisontal 		horizontal level 
horn 		horn 
hos 		at beside by near nearby near to next to 
hospital 		insane asylum 
hosta 		cough 
hot 		menace threat 
hota 		menace threaten 
hotell 		hotel 
hotelse 		menace threat 
hov 		hoof 
hovjärn 		horseshoe 
hud 		skin 
hugg 		blow 
hugga 		chop cut hack 
huggorm 		adder viper 
hugskott 		caprice whim 
humla 		bumblebee 
hummer 		lobster 
humor 		humor humour 
humoristisk 		humourous 
humör 		humour mood temper 
hund 		dog 
hundra 		hundred one hundred 
hunger 		hunger 
hungersnöd 		famine 
hungra 		be hungry 
hungrig 		hungry 
hurra 		hurray 
hus 		house 
husdjur 		domestic animal 
husnummer 		number number of the house 
husockupant 		squatter 
hustru 		wife 
husägare 		house‐owner 
huv 		cap 
huvud 		head pate 
huvudgärd 		pillow 
huvudled 		major road 
huvudskål 		skull 
huvudstad 		capital capital city metropolis 
huvudvärk 		headache 
hvit 		white 
hydda 		cabin hut shack 
hyena 		hyaena 
hyende 		cushion 
hygien 		hygiene 
hygienisk 		hygienic 
hymn 		anthem hymn 
hypnos 		hypnosis hypnotic trance 
hypnotisera 		hypnotize 
hypnotisör 		hypnotist 
hypotek 		mortgage 
hypotes 		hypothesis 
hypotetisk 		hypothetical 
hyra 		hire 
hyra ett rum 		live in lodgings 
hyrbil 		taxi 
hyresgäst 		renter tenant 
hyreskontrakt 		lease 
hysa 		conceal hide 
hysteri 		hysteria 
hysterisk 		hysterical 
hytt 		cabin hut shack 
hyvel 		plane 
hyvla 		abrade plane 
häck 		hedge 
häcka 		incubate sit 
häda 		slander 
hädare 		blasphemer 
hädelse 		blasphemy 
häger 		heron 
hägna 		fence off 
häkta 		clasp hook 
häkte 		apprehension arrest detention 
häl 		heel 
hälft 		half 
häll 		tile 
hälla 		pour scatter shed 
hälsa 		greet salute 
hälsning 		greeting 
hämna 		avenge avenge oneself 
hämnd 		revenge vengeance 
hända 		come about happen occur 
händelse 		chance event occurence opportunity 
händelsevis 		by accident by chance 
hänförelse 		alacrity enthusiasm 
hänga 		droop hang 
hänga upp 		hang 
hängsle 		hinge 
hänsyftning 		allusion 
häntydning 		allusion 
här 		army 
härska 		control govern restrain rule 
härskare 		ruler 
härstamma 		accrue come derive originate result 
häst 		horse 
hästkraft 		horsepower 
hästsko 		horseshoe 
hävda 		assert state 
hävdvunnen 		traditional 
häxa 		witch 
häxeri 		sorcery 
hö 		hay 
höft 		thigh 
höghus 		apartment building block of flats 
högvatten 		high tide 
höjd 		height 
hök 		hawk 
hölja 		cover 
höna 		chicken fowl 
höns 		chicken fowl 
höra 		hear 
hörare 		listener 
hörsam 		obedient 
hörsamma 		obey 
höst 		autumn 
hösta 		harvest 
hövlig 		courteous polite well‐mannered 
håg 		tendency 
hågkomst 		recollection 
hål 		hole 
hålla 		hang onto hold 
hållning 		attitude 
hån 		mockery 
håna 		jeer at make fun of mock 
hår 		hair 
hård 		hard 
hårfrisör 		barber hairdresser 
hårfrisörska 		hairdresser female hairdresser 
i 		a in inside into on per within 
ibland 		among between 
icke 		not 
ideal 		ideal 
idel 		pure 
identisk 		identical 
idiot 		idiot 
idissla 		chew the cud 
idol 		idol 
idrott 		sport 
idé 		idea 
ifrån 		from out of 
ifylla 		fill fill in fill up 
igenom 		through 
igår 		yesterday 
ihop 		together 
ihågkomma 		recall recollect remember 
illa 		bad miserable nasty poor 
illasinnad 		adverse hostile 
illgärning 		crime 
illmarig 		clever cunning sly smart 
illusion 		illusion 
illustrera 		illustrate 
ilsken 		angry cross 
imitera 		imitate 
imma 		steam vapor vapour 
in 		inwards 
inbjuda 		invite 
inbjudan 		invitation 
inbjudning 		invitation 
inbrottstjuv 		burglar 
inbyggare 		inhabitant 
indian 		Indian American Indian 
indisk 		Indian 
individ 		individual 
individuell 		individual 
industri 		industry 
industriell 		industrial 
inemot 		across from against in exchange for opposed to opposite upon 
infall 		on the occasion of 
infanteri 		infantry 
infektion 		infection 
infödd 		aboriginal native 
ingalunda 		by no means in no way not at all not on any account 
ingefära 		ginger 
ingen 		neither nobody none no‐one 
ingenjör 		engineer 
ingenstans 		nowhere 
ingenstädes 		nowhere 
ingenting 		nothing 
inhemsk 		aboriginal domestic 
initialbokstav 		initial 
inne 		at home 
innehava 		own possess 
innehåll 		contents 
inpå 		until till 
inreda 		arrange fix up 
inredning 		accommodation adjustment arrangement 
inregistrera 		record register 
insekt 		bug insect 
insjukna 		be taken ill fall ill 
insjö 		lake loch 
inspektera 		inspect 
inspektion 		inspection 
inspektor 		inspector 
instifta 		erect establish found 
instinkt 		instinct 
instruktion 		directions instruction 
instrument 		agent means tool 
inställa 		install 
inteckning 		mortgage 
internationell 		international 
intervall 		interval 
intervjua 		interview 
intet 		nothing 
inte alls 		not at all 
intill 		until till 
intim 		close intimate 
intolerant 		intolerant 
intressant 		interesting 
intresse 		interest 
intrig 		plot 
inträde 		entrance portal 
inträdesbiljett 		admission ticket 
inträffa 		come about happen occur 
invalid 		disabled 
invandra 		immigrate 
invit 		invitation 
invitera 		invite 
invånare 		inhabitant 
inälvor 		intestines 
inöva 		exercise practise 
inåt 		inwards 
irländare 		Irishman 
irländsk 		Irish 
irra 		roam wander 
is 		ice 
isberg 		iceberg 
isländsk 		Icelandic 
islänning 		Icelander 
italienare 		Italian 
italiensk 		Italian 
i afse 		last night 
i afton 		this evening 
i allmänhet 		generally 
i går 		last night 
i sänder 		at the same time 
ja 		yes 
jacka 		jacket 
jaga 		chase hunt 
jaka 		affirm assent say yes 
jakt 		yacht 
jalu 		envious 
jalusi 		envy 
januari 		January 
japanes 		Japanese 
japanesisk 		Japanese 
japansk 		Japanese 
jarl 		nobleman 
javan 		Javanese 
javanes 		Javanese 
javanesisk 		Javan Javanese 
javansk 		Javan Javanese 
jord 		ground soil 
jordbeck 		asphalt 
jordbruk 		agriculture farming tillage 
jordbrukare 		agrarian farmer 
jordbävning 		earthquake 
jordfästa 		bury 
jordglob 		globe worldglobe 
jordgubbe 		strawberry 
jordklot 		globe worldglobe 
journal 		daily paper journal newspaper 
journalist 		journalist 
ju 		certainly indeed rather surely 
jude 		Hebrew Jew 
judisk 		Hebrew Jewish 
jul 		Christmas Yule 
juli 		July 
jungfru 		virgin 
jungfrulig 		virgin virginal 
juni 		June 
just 		just just now 
juvel 		gem jewel 
juvelerare 		jeweller 
juver 		udder 
jägare 		hunter 
jämföra 		compare 
jämförelse 		comparison 
jämlik 		equal even level 
jämlikt 		according as according to as by 
jämn 		even flat level smooth 
jämna 		even level 
jämvikt 		equilibrium 
jänta 		girl lass wench 
järn‐ 		iron 
järn 		iron 
järnväg 		railroad railway 
järnvägståg 		train 
järv 		wolverine 
jäst 		yeast 
jätte 		giant 
jättelik 		gigantic huge 
kabel 		cable 
kabeljo 		cod codfish 
kabinett 		cabinet 
kadaver 		cadaver corpse 
kaffe 		coffee 
kafé 		café coffee‐house 
kaj 		platform quay wharf 
kajuta 		cabin 
kaka 		cake 
kakao 		cocoa 
kakel 		tile 
kaktus 		cactus 
kalas 		celebration festival party 
kalasa 		celebrate 
kalender 		calendar 
kalk 		lime 
kalkon 		turkey 
kall 		bleak chilly cold 
kalla 		call 
kallas 		be called 
kalv 		calf 
kamel 		camel 
kamfer 		camphor 
kamin 		furnace kiln oven stove 
kamma 		comb 
kammare 		chamber room 
kamp 		action battle scuffle struggle 
kampingplats 		camping ground camping site 
kamrat 		buddy companion comrade pal 
kanadensare 		Canadian 
kanal 		canal channel 
kanapé 		couch sofa 
kanariefågel 		canary 
kanhände 		maybe mayhap perchance perhaps possibly 
kanin 		rabbit 
kanna 		jug pot 
kannibal 		cannibal 
kanon 		cannon 
kanot 		canoe 
kanske 		maybe mayhap perchance perhaps possibly 
kant 		side 
kaos 		chaos tangle 
kap 		cape 
kapital 		capital 
kapitel 		chapter 
kappa 		cloak mantle 
kapprum 		cloakroom 
kappsäck 		trunk 
kapris 		caprice whim 
kapsyl 		capsule firing‐cap 
kapten 		captain 
kaputt 		broken out of order 
kar 		tub vat 
karaff 		carafe decanter 
karaffin 		carafe decanter 
karakterisera 		characterize 
karakterisk 		characteristic 
karaktär 		character nature personality 
karavan 		caravan 
karburator 		carburettor 
karl 		fellow man 
karneval 		carnival 
karp 		carp 
karriär 		career 
kart 		unripe fruit 
karta 		card map menu 
kartong 		cardboard 
kasematt 		bunker shelter 
kasern 		barracks 
kasino 		casino 
kaskad 		waterfall 
kasko 		hull 
kassa 		cashier's stand fund money box money‐box till 
kassör 		cashier 
kasta 		throw 
kastanje 		chestnut horse‐chestnut 
katalog 		catalogue directory 
katarr 		catarrh 
katastrof 		catastrophe 
kateder 		pulpit 
katedral 		cathedral 
kategori 		category 
katolik 		Catholic 
katolsk präst 		pastor vicar 
katt 		cat 
kautschuk 		rubber 
kavalleri 		cavalry 
kaviar 		caviar 
kedja 		chain 
kejsardöme 		empire 
kejsare 		emperor 
kejsarinna 		empress 
kela 		coddle pamper pet 
kemi 		chemistry 
kila 		run 
kilogram 		kilo 
kilometer 		kilometre 
kina 		cinema 
kind 		cheek 
kines 		Chinaman Chinese 
kinesisk 		Chinese 
kirurg 		surgeon 
kirurgisk 		surgical 
kisel 		flint gravel 
kista 		box chest 
kitt 		cement 
kiv 		quarrel 
kjol 		skirt 
kjortel 		skirt 
klaga 		complain 
klagande 		accuser 
klagomål 		accusal accusation 
klar 		clear distinct plain 
klass 		class 
klassisk 		classic classical 
klav 		clef 
klen 		faint light weak 
klentrogen 		skeptical 
klia 		itch 
klibba 		stick 
klicka 		abort fail miscarry 
klientel 		clientèle 
klimat 		climate 
klinga 		blade 
klinik 		clinic 
klint 		cornflower 
klippa 		rock 
klipsk 		clever cunning sly smart 
kliva 		climb 
klo 		claw 
kloak 		sewer 
klocka 		watch 
klockarmband 		watch wrist‐watch 
klok 		sagacious sage wise 
klokhet 		wisdom 
klor 		chlorine 
klosett 		toilet 
kloster 		monastery 
klot 		ball ball‐bearing globe 
klubb 		club society 
klyftig 		clever cunning sly smart 
klyva 		split 
klädedräkt 		costume outfit suit 
kläder 		clothes clothing 
klädsel 		clothes clothing 
klädskåp 		clothes‐press wardrobe 
klänning 		dress gown robe 
klättra 		climb 
klösa 		scratch 
klöv 		hoof 
klöver 		clover shamrock trefoil 
klå 		scratch 
klåda 		itch 
knacka 		hit knock strike 
knaka 		crack 
knapp 		button 
knappast 		barely hardly only just scarcely 
knappnål 		pin needle 
knappt 		barely hardly only just scarcely 
knekt 		pawn soldier 
knep 		subterfuge trick trickery 
knepig 		clever cunning sly smart 
knip 		stomach ache tummy ache 
knippa 		bunch bundle cluster sheaf 
knipslug 		clever cunning sly smart 
kniv 		knife 
knopp 		bud 
knusslare 		miser niggard skinflint 
knut 		knot node 
knyte 		bunch bundle cluster sheaf 
knä 		knee 
knäbyxor 		short pants shorts 
knäck 		push 
knäcka 		break 
knåda 		knead 
ko 		cow 
kock 		cook male cook 
kod 		code 
koffert 		trunk 
koja 		cabin 
koka 		boil 
kokare 		kettle 
kokerska 		cook female cook 
kokosnöt 		coconut 
kol 		coal 
kollega 		colleague 
kollegium 		college 
koloni 		colony settlement 
kolossal 		colossal huge 
koltrast 		blackbird 
komedi 		comedy 
komet 		comet 
komisk 		comic comical funny 
komma 		comma 
kommande 		next 
kommando 		command 
kommendant 		commander 
kommendera 		command be in command order 
kommissarie 		chief of police 
kommission 		commission 
kommitté 		committee 
kommun 		community 
kommunikationstabell 		schedule time‐table 
kommunism 		communism 
kompass 		compass 
kompetent 		able accomplished competent 
kompis 		friend 
komplett 		absolute complete 
komplimang 		compliment 
komplott 		conspiracy plot 
komponera 		compose 
kompositör 		composer 
koncept 		concept idea 
kondition 		condition stipulation terms 
konditor 		confectioner 
konditori 		confectionery 
kondom 		condom rubber 
konduktör 		guard 
konfession 		acknowledgement admission confession 
konfiskera 		confiscate 
konflikt 		conflict 
konfys 		jumbled up 
kongress 		congress convention 
konjak 		brandy cognac 
konklusion 		conclusion inference 
konkret 		concrete 
konkurrens 		competition 
konkurs 		bankruptcy failure 
konsert 		concert 
konservativ 		conservative 
konservera 		conserve keep maintain preserve 
konsonant 		consonant 
konst 		art 
konstalster 		work of art 
konstant 		constant continual permanent sustained 
konstapel 		policeman 
konstföremål 		work of art 
konstgjord 		artificial 
konstgrepp 		subterfuge trick trickery 
konstnär 		artist 
konsul 		consul 
konsulat 		consulate 
konsultera 		consult 
kontakt 		contact 
konto 		account 
kontor 		office 
kontrakt 		contract 
kontramärke 		acknowledgement receipt 
kontrast 		contrast 
kontrollant 		checker controller 
kontrollera 		audit check check up on supervise verify 
kontrollör 		checker controller 
konung 		king 
konungarike 		kingdom 
konungslig 		regal royal 
konvalje 		lily‐of‐the‐valley 
konversation 		conversation 
kopia 		copy 
kopiera 		copy 
kopp 		cup 
koppar 		copper 
koppor 		smallpox 
kor 		chorus coir 
kora 		choose elect pick out 
korespondera 		correspond 
korg 		basket 
kork 		cork 
korkskruv 		corkscrew 
korn 		grain granule pip 
korrekt 		correct right 
korrigera 		correct 
kors 		cross 
korsord 		crossword puzzle 
korstfästa 		crucify 
kort 		card map menu 
kortsynt 		near‐sighted short‐sighted 
korv 		sausage 
kosa 		direction 
kosta 		cost 
kostbar 		dear expensive 
kostnadsfri 		free 
kostym 		costume outfit suit 
kotlett 		cutlet 
krabba 		crab 
krafsa 		scratch 
kraft 		force strength vigour 
kraftfull 		strong 
kraftig 		strong 
krage 		collar 
kram 		barn shed stand 
krama 		embrace hug 
krambod 		bazaar fair market 
kran 		crane 
krasch 		ado din noise 
krasse 		nasturtium 
kratta 		rake 
kredit 		credit 
krets 		district 
krig 		war 
kriga 		make war wage war 
krigare 		warrior 
krigisk 		martial warlike 
kriminal 		criminal 
kring 		about round around towards 
kringgå 		avoid evade 
kris 		crisis depression emergency 
kristall 		crystal 
kristen 		Christian 
kristendom 		Christianity 
kristlig 		Christian 
kristna 		baptize christen 
kristning 		baptism christening 
krita 		chalk 
kritik 		criticism 
krok 		bend curve 
krokig 		bent curved 
krokodil 		crocodile 
krom 		chromium 
kronärtskocka'ärtskocka 		artichoke 
kropp 		body 
kroppslig 		bodily body body‐ corporal corporeal of the body physical 
krossa 		crush shatter smash 
kruka 		jug pitcher 
krumbukt 		bend curve 
krusbär 		gooseberry 
krut 		gunpowder 
kry 		cheerful gay merry 
kryp 		bug insect 
krypa 		crawl creep 
kräfta 		cancer canker 
kräkas 		throw up vomit 
kräla 		crawl creep 
kräldjur 		reptile 
kräm 		cream 
krönika 		chronicle 
kröning 		coronation 
kråka 		crow 
kub 		cube 
kudde 		cushion 
kula 		bullet 
kulle 		hill 
kultur 		culture 
kund 		client customer 
kung 		king 
kungarike 		kingdom 
kunskap 		acquaintance knowledge 
kunskapare 		spy 
kupong 		coupon 
kupé 		compartment coupé 
kurry 		curry 
kurs 		class course 
kurva 		bend curve 
kusin 		cousin 
kust 		coast seaside shore 
kvadrat 		square 
kvadratmeter 		square metre 
kvalitet 		property quality 
kvart 		quarter of an hour 
kvarter 		district neighbourhood quarter 
kvast 		broom 
kvicksilver 		mercury quicksilver 
kvinna 		woman 
kvinnlig 		female feminine 
kvist 		bough branch 
kvitto 		acknowledgement receipt 
kväll 		evening 
kväve 		nitrogen 
kyckling 		chick chicken 
kyffe 		den hovel 
kypare 		waiter 
kyrka 		church church‐building house of worship place of worship 
kyrkogård 		cemetery God's acre graveyard 
kyrkoherde 		pastor 
kysk 		chaste 
kyss 		kiss 
kyssa 		kiss 
käft 		jaws mouth muzzle 
källare 		basement cellar 
kämpa 		fight struggle 
känd 		well‐known 
känguru 		kangaroo 
känna 		be acquainted with know 
kännedom 		acquaintance knowledge 
känsla 		emotion 
kär 		dear lovely 
kärlek 		affection love 
kärna 		core nucleus kernel pit 
kärr 		marsh swamp 
kärv 		acerbic bitter 
kättare 		heretic 
kätteri 		heresy 
kö 		file line rank row turn 
kök 		kitchen 
köksa 		cook female cook 
köl 		keel 
köld 		cold 
kön 		sex 
köpare 		buyer client purchaser 
köpesumma 		purchase money 
köping 		town 
körkort 		driving‐licence 
körsbär 		cherry 
kött 		flesh 
kål 		cabbage 
laboratorium 		laboratory 
lada 		depository 
ladda 		burden load 
lag 		law 
lam 		lame 
lamm 		lamb 
lampa 		lamp 
land 		country land 
landkarta 		map 
landsbo 		countryman peasant 
landsbygd 		country countryside 
landskap 		landscape scenery 
landsmål 		dialect 
landsort 		country countryside 
lans 		lance spear 
lantbruk 		agriculture farming tillage 
lantbrukare 		agrarian farmer 
lapp 		Laplander Lapp 
lappländsk 		Lapp Lappish 
lapsk 		Lapp Lappish 
larm 		alarm 
larma 		make a noise 
larv 		grub larva 
lasta 		burden load 
lastbil 		lorry truck 
lat 		lazy 
latinläroverk 		high school 
lav 		moss 
lava 		lava 
lavin 		avalanche 
lax 		salmon 
laxativ 		laxative 
le 		smile 
ledsen 		dismal gaunt miserable sad 
leende 		smile 
lega 		hire rent rental 
legation 		legation 
legend 		legend 
legering 		alloy 
legitimera 		legitimize 
leja 		hire 
lejon 		lion 
lek 		game 
leka 		play 
lekamen 		body 
lekamlig 		bodily body body‐ corporal corporeal of the body physical 
lekman 		layman 
leksak 		toy 
lekskola 		nursery school 
lektion 		lesson 
lektor 		instructor teacher 
lektyr 		reading matter 
lem 		limb member 
len 		soft 
lena 		soften up 
ler 		clay 
lera 		clay 
leta 		look for seek 
leva 		be alive live 
levande 		alive 
lever 		liver 
leverans 		delivery 
leverera 		deliver furnish supply 
leverkorv 		liver sausage 
levnad 		life 
liberal 		liberal 
lida 		abide bear endure put up with suffer 
lie 		scythe 
ligga 		lie recline 
lik 		equal even level 
likafullt 		but however nevertheless yet 
lika ... som 		as ... as 
likfärd 		mourning 
likgiltig 		immaterial indifferent 
likhet 		resemblance similarity 
likkista 		coffin 
likna 		compare 
liknande 		like alike similar 
liknelse 		comparison 
liknöjd 		immaterial indifferent 
liktorn 		corn 
likvid 		payment 
likör 		liqueur 
lilja 		lily 
liljekonvalje 		lily‐of‐the‐valley 
lim 		glue 
limma 		glue stick 
limonad 		lemonade 
lin 		flax 
lina 		cord rope string 
lind 		lime‐tree linden‐tree 
linjal 		ruler straightedge 
linje 		line 
lins 		lens 
lisma 		flatter 
lita på 		rely on trust in 
lite 		a little rather 
liten 		tiny 
liter 		liter litre 
litet 		a little rather 
litteratur 		literature 
liv 		life 
livaktig 		adroit agile alert brisk keen 
livbåt 		life‐boat 
livlig 		adroit agile alert brisk keen 
livmoder 		uterus womb 
livräddningsbåt 		life‐boat 
ljud 		sound 
ljuda 		sound 
ljudelig 		loud 
ljudlig 		loud 
ljuga 		lie tell a lie 
ljum 		lukewarm 
ljus 		blond fair 
lo 		lynx 
lockande 		attractive 
lodjur 		lynx 
loft 		attic 
logik 		logic 
lojal 		faithful loyal 
lok 		engine 
lokal 		local 
lokomotiv 		engine 
longitud 		longitude 
loppa 		flea 
lotsa 		pilot 
lotteri 		lottery raffle 
lova 		commend laud praise 
lovsång 		anthem hymn 
luft 		air 
luftkrets 		atmosphere 
lunga 		lung 
lupin 		lupine 
lura 		cheat deceive 
lus 		louse 
lutter 		clean 
luttra 		clean cleanse make clean purge 
lyceum 		lyceum 
lycka 		happiness 
lycklig 		fortunate happy 
lyda 		obey 
lydig 		obedient 
lyssna 		listen 
lyte 		absence lack shortage shortcoming 
lyx 		luxury 
läcker 		nice tasty 
läder 		leather 
läderlapp 		bat 
lägenhet 		apartment flat 
läger 		camping ground camping site 
lägga 		lay 
läkare 		doctor physician 
läkemedel 		drug medicine pharmaceutical 
lämna 		abandon forsake desert leave quit 
län 		fief 
längd 		length 
länge 		a long time for a long time long 
längtan 		desire want wish 
längta efter 		ache long for yearn 
läpp 		lip 
lära 		learn 
lärare 		instructor teacher 
lärarinna 		teacher female teacher 
lärka 		lark 
lärkträd 		larch 
läsa 		read 
läskpapper 		blotter blotting paper 
läslig 		legible 
lätt 		easy facile 
lätta 		facilitate 
lättad 		relieved 
lättnad 		relief 
läxa 		lesson 
lödder 		foam froth 
löfte 		affirmation promise 
lögn 		lie 
löjlig 		ridiculous 
löjtnant 		lieutenant 
lök 		onion 
lön 		salary wage wages 
löngivare 		employer 
lönn 		maple sycamore 
lönnlig 		secret 
löntagare 		employee 
löpa 		march walk 
lördag 		Saturday 
löv 		foliage 
låda 		drawer 
låg 		low 
låga 		flame 
låna 		borrow lend loan 
låna av 		lend 
lång 		long 
långfredag 		Good Friday 
långsam 		slow 
lår 		box chest 
lås 		lock 
låsa 		lock 
låt 		melody tune 
låta 		sound 
låtsas som om 		feign pretend 
madrass 		mattress 
magasin 		warehouse 
mage 		stomach 
magisk 		magical 
magknip 		stomach ache tummy ache 
magnet 		magnet 
magnetisk 		magnetic 
maj 		May 
majbagge 		june bug 
major 		major 
majs 		corn Indian corn maize mealies 
maka 		wife 
make 		husband 
makrill 		mackerel 
makt 		ability 
malajisk 		Malay 
malm 		ore 
malt 		malt 
mamma 		mam mammy mom mommy 
man 		husband 
mandarin 		tangerine 
mandel 		almond 
mandom 		courage 
mandråp 		murder 
maner 		manner mode way 
manet 		jelly‐fish 
mangrant 		all 
maning 		admonition exhortation 
manlig 		male masculine 
manöver 		maneuver manœuvre manoeuvre 
mara 		nightmare 
margarin 		margarine 
marin 		navy 
mark 		territory 
marknad 		market sales activity 
marmelad 		jam marmelade 
marmor 		marble 
mars 		March 
marschall 		torch 
marter 		torture 
martera 		agonize torture 
martyr 		martyr 
mask 		mask 
maskin 		engine machine 
massiv 		massive 
mast 		mast 
mat 		food 
matematik 		mathematics 
materia 		matter 
material 		data material 
materiell 		material 
matlust 		appetite 
maträtt 		food 
matsedel 		menu 
maxiumum 		maximum 
med 		with 
medalj 		medal 
medborgare 		citizen 
medbringa 		bring along take along 
meddela 		advertise announce give notice 
meddelande 		ad advertisement 
medeltal 		average 
medeltida 		Middle Ages 
medge 		admit concede grant 
medicin 		drug medicine pharmaceutical 
medlidande 		compassion pity 
medljud 		consonant 
medverka 		cooperate co‐operate 
medvetande 		awareness consciousness 
medvetslös 		unconscious 
meja 		cut mow 
mejsel 		chisel 
mellan 		among between 
melodi 		melody tune 
melon 		melon 
men 		but 
mena 		mean 
mening 		sentence 
menlig 		adverse harmful 
mer 		more 
mera 		more 
merendels 		ordinarily usually 
mes 		titmouse 
mest 		most 
metall 		metal 
meter 		metre 
metkrok 		hook 
metod 		method 
metspö 		fishing rod 
mexikan 		Mexican 
mickel 		fox 
mikroskop 		microscope 
mil 		mile 
mild 		gentle mild 
militär 		warrior 
miljon 		million 
million 		million 
min 		my 
mina 		mine 
minderårig 		under age 
mindretal 		minority 
mineral 		mineral 
minesslö 		forgetful 
minister 		minister 
ministär 		ministry 
minnas 		recall recollect remember 
minne 		memory recollection 
minnesmärke 		monument 
minnesvård 		monument 
minut 		minute 
missa 		miss 
missakta 		despise 
missbelåten 		discontented displeased dissatisfied 
missbilliga 		condemn disapprove disapprove of rebuke 
missbruk 		abuse 
missdåd 		crime 
missförhållande 		abuse 
missförstånd 		misunderstanding 
misskund 		compassion pity 
missnöjd 		discontented displeased dissatisfied 
missräkning 		disappointment 
misstag 		aberration error mistake 
misstanke 		suspicion 
misstro 		distrust suspect 
misstroende 		suspicion 
misstrogen 		suspicious 
misströsta 		despair 
misströstan 		despair 
mist 		fog mist 
mista 		lose 
mistaga sig 		err make a mistake 
mista sig 		err make a mistake 
mitt 		my 
mjuk 		soft 
mjäll 		dandruff 
mjöl 		flour meal 
mjölk 		milk 
mjölka 		milk 
mjölnare 		miller 
mod 		mood 
modell 		model 
moder 		mother 
modern 		modern 
mogen 		mature ripe 
mogna 		ripen 
mohammedan 		Mohammedan Moslem Muslim Mussulman 
molekyl 		molecule 
moln 		cloud 
momang 		instant moment 
moment 		instant moment 
monopol 		monopoly 
monster 		monster 
montera 		assemble link mount 
monument 		monument 
moped 		moped 
mor 		mother 
moras 		marsh swamp 
morbroder 		uncle 
morbror 		uncle 
mord 		murder 
morfar 		maternal grandfather 
morfin 		morphia morphine 
morföräldrar 		grandparents 
morgift 		antidote 
morgon 		morning 
mormoder 		grandfather 
mormon 		Mormon 
mormor 		grandmother 
morot 		carrot 
moské 		mosque 
mossa 		moss 
moster 		aunt 
mot 		across from against in exchange for opposed to opposite upon 
motgift 		antidote 
motiv 		account motive reason 
motor 		engine motor 
motorcykel 		motorcycle 
motsats 		antithesis contradistinction contrast opposition 
motsatt 		adverse alien contrary 
mudder 		mud 
mula 		mule 
mullvad 		mole 
multiplicera 		multiply 
mulåsna 		hinny 
mumie 		mummy 
mun 		mouth 
munk 		monk 
mur 		wall 
mura 		build 
murare 		mason 
murgröna 		ivy 
mus 		mouse 
musa 		muse 
museum 		museum 
musik 		music 
musikalisk 		musical 
musikant 		musician 
musiker 		musician 
muskel 		muscle 
mussla 		mussel 
mustasch 		moustache 
mycket 		quite very very much 
mygga 		gnat 
myndig 		adult grown‐up full‐grown 
mynt 		coin 
mynta 		mint 
myra 		ant emmet 
mysa 		smile 
mysterium 		mystery 
mysteriös 		abstruse mysterious 
mystisk 		mystic mystical 
myt 		myth 
mäklare 		broker 
mäkta 		be able to 
mäktig 		powerful 
mängd 		accumulation crowd heap mass multitude pile 
människa 		man human being 
mänsklig 		human 
mänsklighet 		human race mankind 
märka 		notice 
märklig 		noteworthy remarkable 
märkvärdig 		noteworthy remarkable 
mässing 		brass 
mässling 		measles 
mästare 		boss master 
mästarinna 		mistress 
mästerman 		hangman executioner 
mätt 		full replete satisfied 
mätta 		be full have enough 
mö 		girl lass wench 
möbel 		piece of furniture 
möblemang 		furniture 
möblera 		furnish 
möblerad 		furnished 
möda 		effort 
mödosam 		difficult hard inconvenient 
mögel 		mold mould 
mögla 		get mouldy 
möjlig 		possible 
mönster 		sample specimen 
mör 		soft 
mörda 		murder 
mördare 		murderer 
mörker 		darkness murk 
mössa 		cap 
möta 		come across encounter meet see 
mötas 		meet 
möte 		meeting 
må 		have to must ought to should 
måg 		son‐in‐law 
måhände 		maybe mayhap perchance perhaps possibly 
måla 		paint 
målare 		painter 
målning 		painting picture 
måltid 		meal 
månad 		month 
måndag 		Monday 
måne 		moon 
många 		many 
mård 		marten 
mås 		seagull 
måse 		seagull 
måste 		have to must ought to should 
nackdel 		disadvantage 
nacke 		back of the neck nape 
nafta 		crude oil 
nagel 		nail 
nagelborste 		nail‐brush 
naiv 		naïf naïve 
naken 		bare naked nude 
nalkas 		advance come close come closer come on 
namn 		appellation name 
namnteckning 		signature 
nappa 		bite 
nappflaska 		baby's bottle feeding‐bottle 
narciss 		daffodil narcissus 
narr 		fool 
narra 		cheat deceive 
narri 		gag joke 
nation 		nation 
nationalitet 		nationality 
nationell 		national 
natt 		night 
nattfjäril 		moth 
natur 		nature 
naturgas 		natural gas 
naturlig 		natural 
nazist 		Nazi 
ned 		down 
nedan 		below downstairs underneath 
nederlag 		defeat 
nederländare 		Dutchman 
nederländsk 		Dutch 
nedrig 		abject base low nasty vile 
nedsmutsa 		soil 
nedstämd 		depressed 
nedsvärta 		slander 
nedvänd 		down 
negativ 		negative 
neger 		Negro 
nej 		no 
nejlika 		carnation pink 
neka 		deny 
ner 		down 
nere 		below downstairs underneath 
nerv 		nerve 
nervös 		agitated nervous 
nesa 		shame 
neutral 		impartial neutral 
nickel 		nickel 
niding 		cheat crook rogue 
nie 		nine 
nio 		nine 
nionde 		ninth 
nisch 		niche 
nitti 		ninety 
nittio 		ninety 
nitton 		nineteen 
nittonde 		nineteenth 
nivå 		level 
njugg 		avaricious miserly stingy 
njure 		kidney 
njuta 		be glad enjoy rejoice 
noga 		accurate precise 
noll 		nought zero 
nolla 		naught nought null zero zilch 
nord 		north North 
nordisk 		Scandinavian 
nordlig 		northern 
normal 		normal 
norr 		northern 
norra 		northern 
norra om 		above 
norrman 		Norwegian 
norrut 		north northward northwards 
norr om 		above 
norsk 		Norwegian 
noshörning 		rhino rhinoceros 
nota 		account bill calculation 
notera 		note make a note write down 
notisbok 		notebook 
novell 		short story 
november 		November 
nu 		at present now 
nummer 		number numeral 
nummerplåt 		numberplate 
nunna 		nun 
nutida 		currently nowadays these days 
nuvarande 		currently nowadays these days 
ny 		new novel 
nybörjare 		beginner 
nyck 		caprice whim 
nyckel 		key wrench 
nyfiken 		agog inquisitive 
nymf 		nymph 
nysa 		sneeze 
nyss 		just just now 
nyttig 		advantageous useful 
nyttja 		make use of turn to good account utilize 
nyår 		New Year 
näbb 		beak bill 
näckros 		waterlily 
näktergal 		nightingale 
nämligen 		namely viz. 
näppeligen 		barely hardly only just scarcely 
näpsa 		punish 
när 		when 
närhet 		nearness proximity 
närmaste 		next of kin 
närsynt 		near‐sighted short‐sighted 
närvarande 		present 
närvaro 		presence 
näsa 		nose 
näsborr 		nostril 
nässla 		nettle 
nästan 		almost nearly 
näste 		den nest 
nät 		net network 
näve 		fist 
nöjd 		contented pleased satisfied 
nöt 		bovine bovine animal 
nötkött 		beef 
nå 		now well well then 
nåd 		favor favour 
någon 		a any anybody some somebody one some one some one 
någonsin 		at some time ever sometime 
någonstans 		anywhere somewhere 
någonstädes 		anywhere somewhere 
någonting 		anything something 
någorlunda 		a little rather some somewhat to some extent 
något 		anything something 
nål 		needle 
nåväl 		now well well then 
o‐ 		dis‐ il‐ im‐ in‐ un‐ 
oaktat 		but however nevertheless yet 
oaktsam 		careless negligent 
oangenäm 		bleak dismal dreary horrible ghastly grisly nasty 
oartig 		rude 
oas 		oasis 
oavhängig 		independant 
oavlåtlig 		all the time ceaselessly 
oavsiktlig 		unintentional 
obegriplig 		inconceivable unintelligible 
obegränsad 		absolute 
obehaglig 		bleak dismal dreary horrible ghastly grisly nasty 
obekant 		unknown 
oberoende 		independant 
objekt 		article object thing 
oblandad 		pure 
oblyg 		rude 
observera 		keep mind observe 
obskur 		obscure 
ocean 		ocean 
och 		and 
också 		also likewise too 
ockupera 		overpower usurp 
odjur 		monster 
odräglig 		unbearable 
oenig 		at variance disagreeing 
oenighet 		disagreement discord dissension 
oense 		at variance disagreeing 
ofall 		accident 
ofattlig 		inconceivable unintelligible 
offensiv 		aggressive offensive 
offentlig 		public 
offentliggöra 		publish reveal 
offert 		offer 
officer 		officer 
officiell 		official 
ofruktbar 		barren infertile 
ofta 		frequently often regularly 
ofördelaktig 		adverse detrimental 
ofördragsam 		intolerant 
oförhoppandes 		abrupt 
oförklarlig 		inexplicable 
oförmedlad 		abrupt 
oförmodad 		abrupt 
oförsynt 		rude 
ogift 		single unmarried 
ogärning 		crime 
ogärningsman 		criminal 
ohederlig 		nasty 
ohyra 		vermin 
ohövlig 		rude 
oklar 		indistinct 
okokt 		raw uncooked 
oktober 		October 
oktroj 		patent 
okysk 		lewd 
okänd 		unknown 
olik 		different 
olika 		different 
olikhet 		difference 
oliv 		olive 
olja 		oil 
oljud 		ado din noise 
ollon 		acorn 
olycklig 		unhappy 
olycksfall 		accident 
olydig 		disobedient insubordinate 
olåt 		ado din noise 
om 		about concerning on upon 
omak 		effort 
omdöme 		judgment 
omelett 		omelette 
omfamna 		embrace 
omfång 		bulk dimension extend size 
omfångsrik 		ample bulky extensive 
omgiva 		surround 
omnibus 		omnibus 
omogen 		unripe 
område 		region 
omtanke 		care concern 
omyndig 		under age 
omättlig 		insatiable 
omöjlig 		impossible 
om aftarna 		in the evening 
om morgonen 		in the morning 
om natten 		at night by night during the night 
om än 		though although 
onaturlig 		artificial 
ond 		bad miserable nasty poor 
onsdag 		Wednesday 
oordning 		chaos tangle 
opal 		opal 
opartisk 		impartial 
opera 		opera 
operation 		operation surgical operation 
operera 		operate 
optiker 		optician 
optimism 		optimism 
opålitlig 		unreliable 
orakel 		oracle 
orange 		orange 
ord 		word 
orda om 		discuss 
ordbok 		dictionary vocabulary 
orden 		order 
order 		command 
ordinär 		accustomed customary used to usual wonted 
ordspråk 		adage proverb 
oredig 		dazed perplexed upset 
oregelbunden 		abnormal 
orena 		soil 
organ 		organ 
organisation 		organization 
orgel 		organ 
orient 		east East 
orientalisk 		eastern Oriental 
original 		aboriginal original 
oriktig 		incorrect wrong 
ork 		energy 
orka 		be able to 
orkan 		hurricane 
orkester 		orchestra 
orm 		serpent snake 
orsak 		cause reason 
orsaka 		activate cause give rise to 
ort 		place 
ortlig 		local 
orätt 		incorrect wrong 
osa 		reek smell smell bad stink 
osann 		false untrue 
osedlig 		lewd 
oskuld 		innocence 
oskyldig 		guiltless innocent 
oss 		us 
ost 		cheese 
ostlig 		eastern Oriental 
ostron 		Austrian 
ostyrig 		savage wild 
osympatisk 		nasty 
otacksam 		thankless ungrateful unthankful 
otalig 		countless 
otrevlig 		bleak dismal dreary horrible ghastly grisly nasty 
otro 		suspicion 
otrogen 		suspicious 
otrolig 		incredible 
otur 		bad luck 
otålig 		impatient 
oupphörlig 		constant lasting sustained 
ouppmärksam 		careless negligent 
oval 		oval 
ovan 		unusual 
ovass 		blunt 
oviktig 		unimportant 
oviss 		uncertain 
oväder 		foul weather 
oväldig 		impartial 
ovän 		adversary enemy 
ovänlig 		brutal gruff harsh rough sour surly unkind unpleasant 
oväntad 		abrupt 
oväsen 		ado din noise 
oxe 		ox 
oändlig 		absolute 
oärlig 		nasty 
oövervinnelig 		invincible 
packa 		pack 
packe 		bunch bundle cluster sheaf 
padda 		toad 
paket 		packet parcel 
palats 		palace 
paletå 		coat overcoat 
palm 		palm palmtree 
pamflett 		pamphlet 
panik 		panic 
panna 		forehead 
pantomim 		pantomime 
papegoja 		parrot 
par 		pair 
para 		associate come together join pool 
parad 		display parade 
paradis 		paradise 
paraffin 		paraffin 
paragraf 		paragraph 
parallel 		parallel 
paraply 		umbrella 
parasit 		parasite 
parfym 		perfume 
parisare 		Parisian 
park 		park 
parlament 		parliament 
part 		faction party side 
parti 		faction party side 
partigängare 		member supporter 
partisk 		biased partial 
partvalv 		porch 
pass 		passport 
passagerare 		passenger 
passera 		come about happen occur 
passion 		lust passion 
passionerad 		passionate 
pastor 		pastor 
patent 		patent 
pater 		monk 
patient 		patient 
patriark 		patriarch 
patrull 		patrol 
paus 		break intermission pause recess 
paviljong 		pavilion 
pedal 		pedal 
pelare 		column pillar 
pelikan 		pelican 
pengar 		money 
penna 		feather 
pension 		pension retirement 
peppar 		pepper 
pepparrot 		horse‐radish horseradish 
per 		by by means of on through with 
periferi 		outskirts periphery 
period 		period 
perrong 		platform quay wharf 
perser 		Persian 
persika 		peach 
persilja 		parsley 
person 		person 
personlig 		personal 
personnummer 		personal number 
peruk 		hairpiece wig 
pessimistisk 		pessimistic 
pest 		pestilence plague 
petroleum 		paraffin‐oil petroleum 
piano 		piano 
piggsvin 		porcupine 
pil 		arrow 
pilgrim 		pilgrimage 
piller 		pill 
pilt 		boy lad laddie 
pina 		ache pain 
pingst 		Pentecost Whitsunday 
pinie 		pine pine‐tree 
pinje 		pine pine‐tree 
pinsam 		painful 
pion 		pawn 
pionjär 		pioneer 
pionär 		pioneer 
pipa 		pipe 
pirat 		pirate 
pistol 		pistol spray gun 
planet 		planet 
plank 		board plank 
plant 		plant 
plantera 		plant 
platan 		plane plane‐tree sycamore 
platina 		platinum 
platta 		dial disc record 
plikt 		fine 
plocka 		pick pluck 
plog 		plough 
plommen 		plum 
plym 		plume 
plöja 		plough 
plötslig 		abrupt sudden 
plåga 		agonize torture 
poesi 		poetry 
pojke 		boy lad laddie 
pokal 		goblet 
pol 		pole 
polack 		Pole 
polera 		polish 
polis 		police 
poliskommissarie 		chief of police 
poliskonstapel 		policeman 
polisstation 		police‐station 
politik 		policy politics 
politiker 		politician 
politisk 		political 
polsk 		Polish 
polyp 		polyp 
poppel 		poplar 
populär 		popular 
port 		gate gateway portal 
portativ 		portable 
portfölj 		brief case portfolio 
portion 		share 
portmonnä 		purse wallet 
porto 		postage 
portofri 		post‐paid stamped 
portugis 		Portuguese 
portvakt 		porter 
portvaktare 		porter 
position 		position 
post 		mail post 
postbud 		postman 
postkontor 		post office 
postnummer 		postal code ZIP code 
posttjänsteman 		mailman 
potatis 		potato 
praktik 		practice 
praktisk 		practical 
prata 		chat chatter 
praxis 		tradition 
precis 		accurate precise 
predika 		preach 
predikan 		sermon 
predikant 		preacher 
present 		gift present 
president 		chairman president 
preussare 		Prussian 
preventivmedel 		preservative 
primitiv 		primitive 
princip 		principle 
prins 		prince 
pris 		price 
prisa 		commend laud praise 
privilegium 		privilege 
probera 		attempt test try 
problem 		problem trouble 
procent 		percent percentage 
process 		process 
processa 		act proceed 
procession 		procession 
producera 		afford bear produce 
produkt 		product 
profession 		profession 
professor 		professor 
profet 		prophet 
profil 		profile 
profitera 		profit 
projekt 		plan project scheme 
proklamation 		proclamation 
proletär 		proletarian 
promenad 		stroll walk 
promenera 		go for a walk stroll 
prompt 		accurate on time prompt punctual 
propagando 		propaganda publicity 
prosa 		prose 
prost 		pastor 
protest 		protest 
protestant 		Protestant 
prov 		proof sign token 
prova 		attempt test try 
provbit 		sample specimen 
provins 		province 
provinsiell 		provincial 
präst 		clergyman 
prästgård 		parish 
psalm 		psalm 
pseudonym 		pseudonym 
psyke 		psyche 
psykiater 		psychiatrist 
psykiatri 		psychiatry 
psykiatriker 		psychiatrist 
psykisk 		psychic 
publicera 		publish reveal 
publicist 		journalist 
publik 		public 
puckel 		bump hump 
pudding 		pudding 
puff 		push 
puffa 		push thrust 
puls 		pulse 
pulsera 		pulsate throb 
pulver 		powder 
pump 		pump 
pumpa 		pump 
pund 		pound 
pur 		pure 
purpur 		purple 
puss 		kiss 
pussa 		kiss 
puts 		gag joke 
pyjamas 		pyjamas 
pyramid 		pyramid 
päls 		fur hide skin 
pärla 		pearl 
päron 		pear 
på 		at to toward towards 
påbjuda 		command order tell 
påbud 		command order 
påfallande 		striking 
påfågel 		peacock 
påle 		pole post stanchion stake 
pålitlig 		reliable trustworthy 
påsk 		Easter 
påstå 		assert state 
påstående 		contention assertion 
påve 		pope 
påverka 		act affect influence 
rabbin 		rabbi 
rabies 		rabies 
rackare 		cheat crook rogue 
rad 		file line rank row turn 
radhus 		terrace house terraced house 
radio 		radio wireless 
ragata 		shrew vixen Xanthippe 
ragu 		ragout stew 
rak 		direct straight 
raka 		run 
rakblad 		razor‐blade 
raket 		rocket 
rakkniv 		razor 
ramla 		make a noise 
rang 		grade rank rate 
rapphöna 		partridge 
rapport 		account record report 
rapportera 		give an account report 
rar 		dear lovely 
ras 		breed race 
rasande 		furious 
rasp 		file 
rast 		repose rest 
rasta 		repose rest 
reaktion 		reaction 
reaktionär 		reactionary 
real 		actual practical real 
realisera 		produce 
rebell 		rebel 
recept 		prescription recipe 
redaktör 		editor 
redan 		already by now yet 
redd 		anchorage moorage mooring 
redlig 		above‐board honest 
redo 		finished ready through 
reell 		actual practical real 
regel 		bolt 
regelmässig 		even regular 
regemente 		regiment 
regera 		control govern restrain rule 
regering 		administration government 
regim 		régime 
regissör 		stage‐manager 
register 		account book record register 
registrera 		record register 
regla 		bolt fasten 
reglemente 		regulations rules 
regn 		rain 
regna 		rain 
regnbåge 		rainbow 
regnrock 		raincoat 
reklam 		ad advert advertisement 
rekommendabel 		recommendable 
rekommendation 		recommendation 
rekommendera 		commend recommend 
rekord 		record 
rekryt 		recruit 
rektor 		rector 
relation 		relation 
religion 		religion 
religiös 		religious 
rem 		belt girdle 
ren 		already by now yet 
rena 		clean cleanse make clean purge 
rengöra 		clean cleanse make clean purge 
renlärig 		orthodox 
renommerad 		famous 
rensa 		clean cleanse make clean purge 
renskt vin 		hock Rhine‐wine 
rep 		cord rope string 
reparera 		fix repair 
repertoar 		repertoire 
replik 		answer reply 
reproduktion 		reproduction 
reptil 		reptile 
republik 		republic 
resa 		journey trip voyage 
resande 		traveller 
resebyrå 		tourist agency travel agency 
resgods 		baggage luggage 
respekt 		respect 
respektera 		respect 
rest 		remainder rest 
restaurang 		restaurant 
resultat 		conclusion effect result 
reta sig på 		be indignant with take offence at 
revisor 		accountant 
revolution 		revolution 
revolutionär 		revolutionary 
revolver 		revolver 
rida 		ride 
riddare 		cavalier knight 
rigel 		bolt 
rik 		affluent rich wealthy well‐off 
rikedom 		abundance affluence wealth 
riktig 		fair just righteous 
riktning 		direction 
rim 		rhyme 
rimma 		rhyme 
ring 		ring 
rinna 		flow 
ris 		twig 
risgryn 		rice 
risk 		hazard risk 
riskera 		hazard risk venture 
rita 		design draw 
ritning 		design drawing 
ritual 		ritual 
riva 		rub 
rival 		rival 
ro 		repose rest 
roddbåt 		row‐boat rowing‐boat 
roder 		rudder 
roffa 		plunder rob 
roll 		part role rôle 
roman 		novel 
romare 		Roman 
romersk 		Roman 
ropa 		call summon 
ros 		rose 
rost 		rust 
rosta 		roast toast 
rostbiff 		roastbeef 
rostig 		rusty 
rot 		root 
rote 		district 
rovdjur 		beast of prey 
rubin 		ruby 
rubrik 		column header 
ruckel 		den hovel 
ruelse 		repentance 
ruin 		ruin 
ruinera 		ruin 
rulla 		roll 
rullgardin 		roller‐blind 
rumla 		drink drink to excess 
rumlare 		boozer alcoholic 
rumänsk 		Romanian Rumanian 
rund 		round 
runda 		round round off 
rundfråga 		inquiry investigation 
rusig 		drunk intoxicated 
rutin 		routine 
rutten 		addled bad rotten 
ruva 		incubate sit 
rycka 		jerk pull tug 
rygg 		back 
ryggrad 		spine 
ryggsäck 		backpack knapsack 
ryka 		smoke 
rykte 		rumor rumour 
rymdpilot 		astronaut spaceman 
rymlig 		extensive spacious vast wide 
rymma 		escape flee 
rysk 		Russian 
ryss 		Russian 
rytm 		rhythm 
räcka 		file line rank row turn 
rädd 		afraid 
rädda 		keep save rescue 
räddning 		salvage salvation recovery 
räddningsbåt 		life‐boat 
rädisa 		radish 
rädsla 		agony anguish fear 
räfsa 		rake 
räkna 		prawn 
rämna 		burst 
rät 		direct straight 
rätt 		justice righteousness 
rätta 		fix repair 
rättegång 		action lawsuit 
rättslig 		legal 
räv 		fox 
rävhona 		vixen 
röd 		red 
rödspotta 		plaice 
rödspätta 		plaice 
rök 		smoke 
röka 		smoke 
rökelse 		incense 
rökkupé 		smokers 
rönnbär 		mountain‐ash berry rowan berry 
rör 		barrel channel pipe tube 
röra 		admixture mixture 
röst 		voice 
rösta 		vote 
röva 		plunder rob 
rövare 		robber 
rå 		yard 
råd 		advice counsel 
råda 		advise counsel 
rådfråga 		consult 
rådhus 		town‐hall 
rådjur 		roe 
rådman 		alderman 
råg 		rye 
råma 		howl roar 
råna 		rob 
rånare 		robber 
råtta 		mouse 
råttfälla 		mousetrap 
sabbat 		Sabbath 
sadel 		saddle 
saft 		lemonade 
saga 		fairy tale 
sak 		affair business business deal case matter 
sakna 		miss 
saknad 		absence lack shortage shortcoming 
saknas 		be lacking be missing 
sakrament 		sacrament 
salad 		lettuce 
salamander 		salamander 
saldo 		balance 
saliv 		saliva 
sallat 		lettuce 
salong 		lounge parlour salon sitting‐room 
salt 		salty 
saltvatten 		salt water 
samarbeta 		cooperate co‐operate 
sambo 		co‐occupant 
samhälle 		society 
samklang 		harmony 
samla 		collect gather pick up 
samlare 		accumulator 
samling 		collection 
samliv 		society 
samman 		together 
sammanblanda 		blend mingle mix shuffle 
sammankomst 		assemblage gathering meeting 
sammanlevnad 		society 
sammanlikning 		comparison 
sammanträde 		assemblage gathering meeting 
samt 		equally likewise 
sand 		sand 
sandal 		sandal 
sandbank 		bank sandbank 
sandig 		sand sand‐ of sand 
sann 		true 
sannerligen 		absolutely genuinly indeed really truly 
sanning 		truth 
sannolik 		likely probable 
sardin 		sardine 
sarkastisk 		acid sarcastic 
sats 		sentence 
sax 		scissors 
scen 		scene 
scepter 		sceptre 
schackbräde 		chessboard chess‐board 
schakal 		jackal 
schal 		shawl 
schavott 		scaffold 
schema 		model pattern scheme 
schweizare 		Swiss 
schweizisk 		Swiss 
se 		see 
sedan 		... ago 
sedel 		bank‐note 
sedesam 		chaste 
sedeslös 		lewd 
sefyr 		zephyr 
segel 		sail 
segla 		sail 
sekel 		centennial century 
sekretarere 		secretary 
sekt 		sect 
sektion 		section 
sekund 		second 
selleri 		celery 
semester 		vacation 
semitisk 		Semitic 
semla 		roll 
sena 		muscle 
senap 		mustard 
september 		September 
serbisk 		Serb 
serenad 		serenade 
sergeant 		sergeant 
serie 		series set 
servett 		napkin 
sex 		sex 
sexti 		sixty 
sextio 		sixty 
sextionde 		sixtieth 
sexton 		sixteen 
sextonde 		sixteenth 
sexuell 		generative sexual 
sfär 		ball sphere 
shoppa 		shop 
siare 		prophet 
siberisk 		Siberian 
sida 		side 
siden 		silk 
signa 		bless 
signal 		mark sign signal token 
sikt 		sieve 
sikta 		sift 
sil 		filter 
sila 		filter 
silhuett 		outline silhouette 
silke 		silk 
silkesmask 		silkworm 
sill 		herring 
silver 		silver 
simbyxor 		swimming trunks 
simma 		float swim 
simpel 		simple straightforward 
sin 		her his its their 
sinnesrörelse 		emotion 
sippa 		anemone 
sirap 		syrup 
siska 		last 
sitt 		her his its their 
sitta 		sit 
sittplats 		seat 
situation 		circumstances condition situation 
sju 		seven 
sjubb 		raccoon racoon washing‐bear 
sjuk 		ill sick 
sjukhem 		hospital 
sjukhus 		hospital 
sjuksköterska 		nurse 
sjukvårdare 		nurse 
sjunde 		seventh 
sjunga 		sing 
sjunka 		sink 
sjutti 		seventy 
sjuttio 		seventy 
sjutton 		seventeen 
sjuttonde 		seventeenth 
själ 		mind 
själfständig 		independant 
själsläkekonst 		psychiatry 
själv 		self herself himself itself 
självbehärskning 		restraint self‐command self‐control self‐possession 
självförtroende 		self‐confidence self‐reliance 
självljud 		vowel 
självmant 		voluntary 
självständig 		independant 
självverkande 		automatic 
sjätte 		sixth 
sjö 		lake loch 
sjömakt 		navy 
sjöman 		sailor 
sjörövare 		pirate 
sjötunga 		sole 
skalbagge 		beetle 
skald 		poet 
skalle 		skull 
skam 		shame 
skamlös 		abandoned 
skandal 		commotion scandal 
skapa 		create 
skapelse 		creature 
skata 		magpie 
skatt 		treasure 
sked 		spoon 
skelett 		skeleton 
skepp 		ship vessel 
skeppare 		captain 
skeppsbåt 		life‐boat 
skild 		divorced 
skiljas 		get a divorce get divorced 
skillnad 		difference 
skilsmässa 		divorce 
skinka 		ham 
skinn 		skin 
skinna 		skin 
skiva 		dial disc record 
skjorta 		vest 
sko 		shoe 
skoband 		shoe‐lace 
skog 		forest woods 
skoj 		gag joke 
skoja 		jest joke 
skola 		school 
skorsten 		chimney smokestack 
skotsk 		Scottish 
skotte 		Scot Scotsman 
skottår 		leap‐year 
skratt 		laughter 
skratta 		laugh 
skred 		avalanche 
skri 		cry shout 
skria 		cry out scream shout 
skrifta sig 		confess 
skriftermål 		confession 
skrik 		cry shout 
skrika 		jay 
skriva 		write 
skrivare 		clerk 
skrivbok 		exercise‐book folder notebook 
skrivbord 		desk writing desk writing‐desk 
skrivmaskin 		typewriter 
skrock 		superstition 
skruv 		screw 
skruva 		screw 
skruvmejsel 		screwdriver 
skrymta 		dissemble 
skryta 		boast brag 
skräddare 		tailor 
skråla 		cry out scream shout 
skugga 		shadow 
skuld 		blame fault guilt 
skuldra 		shoulder 
skulptör 		sculptor 
skum 		foam froth 
skumrask 		dusk 
skurk 		cheat crook rogue 
skutt 		jump leap 
skutta 		jump leap spring 
sky 		cloud 
skydda 		protect 
skyddsling 		protégée 
skyffel 		spade 
skyla 		cover 
skyldig 		guilty 
skylla 		accuse 
skylt 		shield sign‐board 
skymning 		dusk 
skägg 		beard 
skälla 		bark 
skälla ut 		abuse insult offend 
skällsord 		invective term of abuse 
skälva 		quiver shiver tremble 
skämd 		addled bad rotten 
skämt 		gag joke 
skämta 		jest joke 
skänk 		gift present 
skänka 		donate give 
skärpa 		acerbity acrimony acuity sharpness 
sköka 		hooker whore 
sköldpadda 		tortoise 
skön 		beautiful fine handsome lovely 
skönhet 		beauty 
skönja 		see 
skönjbar 		visible 
skörd 		harvest 
skörda 		harvest 
sköta 		attend nurse tend to 
skåda 		see 
skådespel 		show spectacle 
skådespelerska 		actress 
skål 		cheers good health 
skåp 		cabinet closet cupboard sideboard 
sladd 		cord rope string 
slag 		action battle scuffle struggle 
slagbom 		barrier fence 
slagsmål 		action battle scuffle struggle 
slaktare 		butcher 
slakteri 		butcher's shop 
slakthus 		abattoir slaughterhouse 
slaktoffer 		victim 
slam 		mud 
slav 		slave 
slavisk 		Slavic 
slem 		mucus phlegm 
slentrianmässig 		automatic 
slipa 		sharpen 
slira 		glide slip 
slopa 		break down demolish pull down take down 
slott 		castle 
slug 		clever cunning sly smart 
slump 		accidence chance hazard 
slup 		boat ship's boat shallop sloop 
slut 		end ending 
sluta 		end come to an end end up expire 
släknamn 		surname 
släkt 		relations relatives 
släkting 		relative 
släktskap 		affiliation blood‐relationship affinity relationship 
slätt 		plain 
slösa 		waste 
slöseri 		waste 
slå 		beat hit strike 
slåss 		fight struggle 
smacka 		smack 
smak 		taste 
smaka 		taste 
smakfull 		nice tasty 
smaklig 		nice tasty 
smaklös 		tasteless 
smal 		gaunt lean slender thin 
smaragd 		emerald 
smed 		smith 
smicker 		flattery 
smickra 		flatter 
smida 		forge 
smidig 		flexible 
smink 		make up make‐up 
smittrena 		disinfect 
smuggla 		smuggle 
smutsa 		soil 
smutsig 		dirty filthy nasty soiled unclean 
smycka 		adorn decorate ornament 
smäcker 		slender slim 
smäkta 		ache 
smälta 		melt 
smärt 		slender slim 
smärta 		hurt 
smärtsam 		painful 
smör 		butter 
smörgås 		bread and butter 
småle 		smile 
småleende 		smile 
snabbskrift 		shorthand stenography 
snacka 		chat chatter 
snart 		soon 
snava 		stumble 
snickare 		carpenter 
snickra 		build build from wood 
snigel 		snail 
sniken 		acquisitive eager greedy 
snodd 		cord rope string 
snok 		serpent snake 
snoka 		spy 
snubbla 		stumble 
snuva 		cold 
snyltgäst 		parasite 
snyltväxt 		parasite 
snäcka 		snail 
snäll 		affable friendly good‐natured kind 
snälltåg 		fast train 
snäsig 		brutal gruff harsh rough sour surly unkind unpleasant 
snö 		snow 
snödroppe 		snowdrop 
snöping 		eunuch 
snöra 		bind connect join tie tie up 
snöre 		cord rope string 
snövit 		snow white 
snål 		acquisitive eager greedy 
so 		sow 
social 		social 
socialism 		socialism 
socka 		sock 
socken 		parish 
socker 		sugar 
sockerrör 		sugar‐cane 
sockersjuka 		diabetes 
sockerskål 		sugar‐bowl sugarbowl 
sofa 		sofa 
sol 		sun 
sold 		salary wage wages 
soldat 		pawn soldier 
solig 		solair sun sun‐ of the sun 
solist 		soloist 
solnedgång 		sunset 
solros 		sunflower 
solstråle 		sunbeam 
soluppgång 		sunrise 
somliga 		a few any some 
sommar 		summer 
son 		son 
sonat 		sonata 
sondotter 		granddaughter 
sonhustru 		daughter‐in‐law 
sonson 		grandson 
sopa 		sweep 
sopkvast 		broom 
soppa 		soup 
sorg 		care concern 
sorgsen 		dismal gaunt miserable sad 
sort 		kind sort 
sortiment 		assortment 
sot 		soot 
sovra 		clean cleanse make clean purge 
sovrum 		bedroom 
sovvagn 		sleeping‐car 
spad 		gravy sauce 
spade 		spade 
spalt 		column pillar 
spanjor 		Spaniard 
spannmål 		grain 
spara 		save spare 
spark 		kick 
sparka 		kick 
sparris 		asparagus 
sparsam 		thrifty 
sparv 		sparrow 
spasm 		clamp brace bracket parenthesis staple 
spatsera 		go for a walk stroll 
spatsertur 		stroll walk 
spe 		mockery 
specerihandlare 		grocer 
speciell 		particular special 
spegel 		looking‐glass mirror 
speja 		spy 
spejare 		spy 
spektakel 		show spectacle 
spel 		game 
spela 		play 
spenat 		spinach 
spene 		nipple 
spik 		nail 
spika 		nail 
spindel 		axis axle 
spindelväv 		spiderweb 
spion 		spy 
spionera 		spy 
spira 		sceptre 
spiral 		spiral 
spiritism 		spiritualism 
spirituell 		lively witty 
spis 		furnace kiln oven stove 
spjut 		lance spear 
splittra 		splinter 
sporadisk 		sporadic 
sport 		sport 
sportsman 		sportsman 
spott 		saliva 
springa 		race run 
springare 		knight 
springvatten 		fountain 
sprit 		alcohol 
språk 		language tongue 
språklära 		grammar 
språksam 		talkative 
spy 		throw up vomit 
späck 		bacon 
spöke 		ghost phantom 
spörja 		ask 
spörsmål 		question 
spårvagn 		streetcar tram 
stack 		heap pile stack 
stad 		city town 
stadig 		fixed 
stadsbud 		porter 
stadshus 		city hall town hall 
stadslik 		urban 
stam 		stem trunk 
standar 		flag standard 
stank 		stench 
stanna 		remain stay stay over 
stare 		starling 
stark 		strong 
stat 		state 
station 		stage station stop 
statistik 		statistics 
statsman 		politician 
statut 		by‐laws statute regulations 
staty 		statue 
stav 		baton cane stick 
stava 		spell 
stavelse 		syllable 
steg 		pace step stride 
stege 		ladder 
sten‐ 		metalled stone 
sten 		stone 
stenhuggare 		stone‐cutter stonemason 
stenig 		metalled stone 
stenrik 		immensely rich rolling in money 
stepp 		moor steppe 
steril 		sterile 
stia 		sty 
sticka 		match 
stig 		path 
stil 		style 
stinka 		reek smell smell bad stink 
stirra 		gaze peer stare 
stjälk 		blade stalk 
stjärna 		star 
stjärntydare 		astrologer 
stjärt 		backside rump 
stoisk 		stoic stoical 
stoj 		ado din noise 
stol 		chair 
stolle 		lunatic 
stollig 		crazy insane mad nuts 
stolt 		proud 
stolthet 		pride 
stop 		jug pitcher 
stor 		big great large 
storhet 		bulk dimension extend size 
stork 		stork 
storlek 		bulk dimension extend size 
storm 		storm 
storma 		assault storm 
straff 		punishment 
straffa 		punish 
straffavgift 		fine 
strand 		beach 
streck 		ray strip stripe 
strejk 		strike 
strejka 		strike 
strid 		action battle scuffle struggle 
strida 		fight struggle 
strimla 		ray strip stripe 
strimma 		ray strip stripe 
strumpa 		sock 
strumpsocka 		sock 
strupe 		throat 
struts 		ostrich 
strykjärn 		iron flat‐iron 
strypa 		choke strangle 
ström 		current flow stream 
ströming 		current 
strömma 		flow 
strå 		blade stalk 
stråla 		radiate 
stråle 		beam ray 
stråt 		path 
student 		academic student 
studera 		study 
studie 		study 
studium 		study 
studsa 		rebound 
stum 		dumb mute speechless 
stygg 		bad miserable nasty poor 
styre 		handlebars helm rudder 
styrka 		force strength vigour 
styv 		rigid stiff 
städerska 		maid servant 
städhjälp 		maid servant 
ställa 		lay down place put put down 
ständigt 		always ever 
stänga 		open open up 
stängd 		open 
stöd 		prop support 
stödja 		lean support sustain 
stöld 		abstraction theft 
stöna 		groan moan 
stöpa 		pour scatter shed 
stör 		pole post stanchion stake 
stöt 		push 
stöta 		push thrust 
stövel 		boot 
stål 		steel 
stång 		baton cane stick 
subjekt 		subject 
subsidier 		subsidy 
substantiv 		noun substantive 
subtil 		subtle 
sucka 		sigh 
suga 		suck 
suggestion 		the power of suggestion 
summa 		amount sum 
sump 		marsh swamp 
sund 		strait 
sundhet 		health 
supa 		drink drink to excess 
supare 		boozer alcoholic 
sur 		dismal 
surna 		acidify sour grow sour 
surra 		buzz hum 
suverän 		sovereign 
svag 		faint light weak 
sval 		cool 
svala 		swallow 
svamp 		fungus mushroom 
svan 		swan 
svans 		tail 
svar 		answer reply 
svara 		answer reply respond 
svart 		black 
svavel 		brimstone sulphur 
svek 		swindle 
svensk 		Swedish 
svenska 		Swedish Swedish language 
svett 		perspiration sweat 
svettas 		sweat 
svimma 		faint swoon 
svin 		hog pig swine 
svinga 		brandish fling swing wave wave about 
svägerska 		sister‐in‐law 
svält 		hunger 
sväng 		bend curve 
svära 		blaspheme cuss curse swear 
svärd 		sword 
svärdotter 		daughter‐in‐law 
svärfader 		father‐in‐law 
svärfar 		father‐in‐law 
svärföräldrar 		parents‐in‐law 
svärm 		swarm 
svärmor 		mother‐in‐law 
svärson 		son‐in‐law 
sväva 		float hover 
svåger 		brother‐in‐law 
svår 		difficult hard inconvenient 
svårighet 		difficulty trouble 
sy 		sew 
syd 		south 
sydlig 		south southern 
symbol 		symbol 
symfoni 		symphony 
symmetrisk 		symmetric 
sympati 		sympathy 
sympatisk 		sympathetic 
synagoga 		synagogue 
synas 		appear appear to be seem 
synbarligen 		evident obvious 
synd 		sin transgression 
synda 		sin transgress 
syndabekännelse 		confession 
syndig 		sinful 
synlig 		visible 
synnerlig 		extraordinary formidable 
synpunkt 		viewpoint 
syra 		acid 
syre 		oxygen 
syren 		lilac 
syrsa 		cricket 
syskon 		brothers and sisters siblings 
system 		system 
systematisk 		systematic 
syster 		sister 
systerdotter 		niece 
systerson 		nephew 
säd 		grain 
säga 		say tell 
säga adjö 		say goodbye say goodbye to take leave take leave from 
säga adjö till 		say goodbye say goodbye to take leave take leave from 
sägen 		legend 
sägn 		legend 
säker 		certain sure 
säkerhetsnål 		safety‐pin safety pin 
säl 		seal sea‐dog 
sälja 		dispose of sell vend 
sällsam 		rare 
sällspord 		rare 
sällsynt 		rare 
sämre 		worse 
sämst 		worst 
sända 		send transmit 
sändebud 		ambassador emissary envoy messenger 
säng 		bed 
sängkammare 		bedroom 
sängplats 		sleeping‐accomodation sleeping‐place 
särskild 		apart particular separate special 
säsong 		season 
säteri 		estate farm property ranch 
sätt 		manner mode way 
sätta 		lay down place put put down 
söder 		south 
södra 		south southern 
söka 		run for election 
sökande 		candidate 
sömn 		sleep 
söndag 		Sunday 
sörja 		mud 
söt 		gentle soft sweet tender 
sötvatten 		fresh water 
så 		barrel 
sådan 		such such a that kind of 
såg 		saw 
såga 		saw 
såll 		sieve 
sålla 		sift 
sålunda 		so such thus 
sång 		singing 
sångare 		singer 
sångerska 		singer female singer 
sångmö 		muse 
såpa 		soap 
sår 		injury wound 
såra 		hurt wound 
sås 		gravy sauce 
såt 		close intimate 
såvida 		if provided that 
såvitt 		if provided that 
ta 		get lay hold of pick up take 
tabell 		index table tablet tabulation 
tack 		gratitude thanks 
tacka 		thank 
tacka för 		acknowledge thank for 
tacka ja till 		accept receive take take in 
tacka nej till 		reject 
tacksam 		thankful 
tack ska du ha 		thank you thanks 
tack så mycket 		thank you very much 
tack tack 		thank you thanks 
taga 		get lay hold of pick up take 
tagg 		thorn 
tak 		ceiling 
tala 		speak talk 
talang 		aptitude disposition talent 
tall 		pine pine‐tree 
tallricksslickare 		cadger parasite sponger 
tallrik 		plate 
talltrast 		thrush 
tallös 		countless 
tam 		tame 
tand 		tooth 
tandborste 		tooth‐brush 
tandkräm 		tooth‐paste 
tandkött 		gum 
tandläkare 		dentist 
tandpetare 		toothpick 
tandvärk 		toothache 
tanke 		thought 
tant 		aunt 
tapet 		tapestry wall covering 
tapetsera 		paper 
tapetserare 		paperer paper‐hanger 
tapper 		brave courageous valiant 
tarm 		intestine 
tass 		claw 
tattare 		gypsy Gypsy 
tavla 		painting picture 
taxa 		tax 
taxera 		tax 
ta hänsyn till 		pay attention to take account of take into account 
te 		tea 
teater 		theatre 
teaterpjäs 		play theatre play 
tecken 		character mark sign signal token 
teckna 		design draw 
teckning 		design drawing 
tegelsten 		brick 
tekanna 		tea‐pot 
teknik 		technics technique 
teknisk 		technical 
telefon 		telephone 
telefonera 		telephone 
telefonhytt 		call box telephone kiosk phone booth telephone booth 
telegraf 		telegraph 
telegrafera 		telegraph 
telegram 		telegram 
television 		television TV 
telning 		child offspring young 
tema 		theme topic subject 
tempel 		temple 
temperatur 		temperature 
tempo 		speed 
tenn 		tin 
tenor 		tenor 
teori 		theory 
term 		term 
termometer 		thermometer 
terrass 		terrace 
terrorism 		terrorism 
terräng 		ground grounds terrain 
testamente 		testament will 
text 		lyric text 
tid 		time while 
tidig 		early 
tidningsman 		journalist 
tidskrift 		periodical 
tidtabell 		schedule time‐table 
tie 		ten 
tiga 		be quiet 
tiger 		tiger 
tigga 		beg 
tiggare 		beggar 
tiggeri 		begging 
tiggerska 		beggar‐woman 
tilja 		floor 
till 		at to toward towards 
tillaga 		prepare 
tillbedja 		adore worship 
tillfälle 		chance event occurence opportunity 
tillfällighet 		accidence chance hazard 
tillfälligtvis 		by accident by chance 
tillförlitlig 		reliable trustworthy 
tillhopa 		together 
tillit 		confidence faith trust 
tillkommande 		future 
tillkomst 		arrival 
tillkännagiva 		acquaint let know inform 
tillkännagivande 		advice announcement communication message notice report 
tillnamn 		surname 
tillreda 		prepare 
tillreds 		finished ready through 
tills 		until till 
tillsammans 		together 
tillvaro 		existence 
till exempel 		for example for instance 
till salu 		for sale 
till uthyrning 		for rent 
timme 		hour o'clock time 
tinning 		temple 
tio 		ten 
tionde 		tenth 
tipp 		hint tip 
tippa 		bet wager 
tisdag 		Tuesday 
tissla 		whisper 
titel 		degree heading title 
titta 		see 
tjock 		bold corpulent fat thick 
tjocka 		fog mist 
tjockben 		calf 
tjockhet 		thickness 
tjocklek 		thickness 
tjugo 		twenty 
tjugoen 		twenty‐one 
tjugoett 		twenty‐one 
tjugonde 		twentieth 
tjugu 		twenty 
tjur 		bull 
tjuv 		thief 
tjuvgömmare 		fence 
tjuvnad 		abstraction theft 
tjänare 		boy servant 
tjänarinna 		maid servant 
tjänst 		service 
tjänstflicka 		maid servant 
tjänstsökande 		candidate 
tjära 		tar 
toalett 		toilet 
toalettpapper 		toilet‐paper 
tobak 		tobacco 
toffel 		slipper 
toga 		toga 
tok 		crazy insane mad nuts 
tokig 		crazy insane mad nuts 
tolerant 		tolerant 
tolfte 		twelfth 
tolk 		interpreter 
tolka 		interpret 
tolv 		twelve 
tom 		empty void 
tomat 		tomato 
tomhet 		emptiness 
ton 		tone 
tona 		sound 
tonsättare 		composer 
tordön 		thunder 
torg 		plaza square public square 
torka 		dryness 
torn 		thorn 
torr 		dry 
torsdag 		Thursday 
torsk 		cod codfish 
tortera 		agonize torture 
tortyr 		torture 
total 		overall total 
tradition 		tradition 
trafik 		traffic 
trafikant 		passenger 
trakt 		region 
traktera 		deal with handle treat 
trall 		melody tune 
trampa 		pedal 
transpirera 		sweat 
transport 		transport 
transportera 		transport 
trappa 		staircase stairs 
trassel 		chaos tangle 
trast 		thrush 
tratt 		funnel 
tre 		three 
tredje 		third 
trefaldig 		triple 
trehörnig 		triangular 
trehörning 		triangle 
tretti 		thirty 
trettio 		thirty 
tretton 		thirteen 
trettondag 		Epiphany Twelfth‐night 
trettonde 		thirteenth 
trevlig 		agreeable enjoyable lovely nice pleasant 
triangel 		triangle 
triangulär 		triangular 
tribun 		rostrum speaker's platform 
tribut 		tax 
triumf 		triumph 
triumfera 		triumph 
trivial 		commonplace course vulgar 
tro 		account accredit believe deem 
troende 		religious 
trolig 		plausible 
troligtvis 		probably 
trolla 		bewitch 
trolleri 		enchantment magic sorcery witchcraft wizardry 
tron 		throne 
tropisk 		tropical 
trots 		despite in spite of notwithstanding 
trottoar 		pavement sidewalk 
trovärdig 		plausible 
tro på 		believe in 
trumpet 		trumpet 
tryck 		pressure 
trycka 		press oppress squeeze 
tryckpress 		press 
trygg 		certain sure 
trä‐ 		wooden 
trä 		timber wood 
träd 		tree 
trädgård 		garden 
trädgårdsmästare 		gardener 
träffas 		meet 
träl 		serf villain 
träla 		work hard 
träsk 		marsh swamp 
trög 		slow 
trögdjur 		sloth 
tröskel 		sill threshold 
tröst 		consolation 
trösta 		comfort console 
tröstlös 		desolate 
trött 		tired 
tröttna 		get tired 
tråd 		thread 
trång 		narrow 
tsar 		czar 
tu 		two 
tuberkulos 		tuberculosis 
tuggummi 		chewing‐gum 
tuktig 		chaste 
tull 		custom‐house 
tulpan 		tulip 
tum 		inch 
tumme 		thumb 
tumult 		agitation riot tumult 
tung 		burdensome heavy onerous 
tunga 		tongue 
tungomål 		language tongue 
tunn 		gaunt lean slender thin 
tunna 		barrel 
tunnel 		tunnel 
tunnelbana 		subway underground 
tupp 		cock rooster 
tur 		luck 
turist 		tourist 
turk 		Turk 
tusch 		nasturtium 
tusen 		thousand one thousand 
tusenfoting 		centipede 
tveka 		hesitate 
tvekan 		hesitation 
tvenne 		two 
tvetydig 		ambiguous 
tvilling 		twins 
tvillingar 		twins 
tvinga 		compel force 
tvist 		quarrel 
tvista 		quarrel wrangle 
tvivelaktig 		doubtful 
tvivla 		doubt 
tvätta 		wash 
tvätterska 		laundress 
två 		two 
tvål 		soap 
två hundra 		two hundred 
tycka 		account deem opine think 
tyckas 		appear appear to be seem 
tycka illa om 		dislike 
tycka om 		appreciate like 
tycka synd om 		have compassion on pity 
tycke 		opinion 
tydlig 		clear distinct plain 
tyg 		agent means tool 
typ 		type 
typisk 		typical 
tyrann 		tyrant 
tyrannisera 		tyrannize 
tysk 		German 
tyska 		German German language 
tyst 		silent 
tyvärr 		alas regrettably unfortunately 
täcka 		cover 
tändsticka 		match 
tändstift 		plug spark plug 
tänka 		think 
tärning 		die 
tätting 		sparrow 
tävlan 		competition 
tävling 		competition contest 
töcken 		fog mist 
töcknig 		fuzzy misty 
töras 		be bold dare 
törhända 		maybe mayhap perchance perhaps possibly 
törn 		push 
törne 		thorn 
törst 		thirst 
törstig 		thirsty 
tös 		girl lass wench 
töväder 		melting thaw 
tå 		toe 
tåga 		fiber fibre 
tåla 		endure put up with tolerate 
tålamod 		patience 
tålig 		patient 
tålmodig 		patient 
tår 		tear 
tårta 		pie tart 
uggla 		owl 
ull 		wool 
ulv 		wolf 
umgås med 		associate with 
undanflykt 		pretext 
under 		miracle 
underbar 		miraculous 
underbyxor 		drawers panties underpants 
underhålla 		alimony 
underjordisk 		underground 
underofficer 		noncom non‐commissioned officer 
underskrift 		signature 
underskriva 		sign 
undersöka 		examine 
undersökning 		investigation examination test 
underteckna 		sign 
undervisa 		teach 
undervisning 		instruction 
underårig 		under age 
undfly 		avoid evade 
undflykt 		escape 
undfå 		get have receive 
undkomma 		escape flee 
undra 		marvel marvel at wonder 
undran 		astonishment wonder surprise 
undseende 		respect 
undskylla sig 		apologize 
ung 		young 
ungdom 		youth 
ungdomlig 		young 
unge 		child offspring young 
ungefär 		about approximately 
ungefärlig 		about approximately 
ungrare 		Hungarian 
uniform 		uniform 
unik 		unique 
union 		union 
universal 		general universal worldwide 
universell 		general universal worldwide 
universitet 		university 
upp 		above up uphill upwards 
uppacka 		unpack 
uppbjuda 		invite 
uppe 		above on top overhead upstairs 
uppenbar 		evident obvious 
uppfattning 		opinion 
uppfinning 		invention 
uppfostra 		breed bring up educate raise 
uppfostran 		education 
uppfylla 		fill fill in fill up 
uppförande 		behavior behaviour conduct deportment 
uppföra sig 		behave conduct oneself 
uppgiven 		exhausted tired out worn out 
upphisa 		lever lift raise 
upphitta 		find 
upphov 		lineage 
upphäva 		lever lift raise 
upphöja 		lever lift raise 
uppkomst 		lineage 
uppkäftig 		impertinent 
uppleva 		go through live to see 
upprepa 		repeat 
uppskatta 		appraise estimate rate 
uppskov 		adjournment delay 
upptill 		above on top overhead upstairs 
upptäcka 		discover uncover 
upptäckt 		discovery 
upptåg 		gag joke 
uppvisa 		indicate point out show 
uppväxtår 		youth 
uppåt 		above up uphill upwards 
ur 		watch 
urbild 		prototype 
urmakare 		watchmaker 
urmodig 		old‐fashioned out of date 
urna 		jug box container vessel 
ursinnig 		furious 
urskog 		primeval forest 
urskulda 		excuse 
ursprung 		lineage 
ursprunglig 		coming 
ursäkta 		excuse me 
ursäkte sig 		apologize 
urval 		chrestomathy 
ut 		from out of 
utan 		without 
utav 		from out of 
utblotta 		rob 
utbörding 		foreigner stranger 
utdela 		distribute 
utdelning 		distribution 
ute 		abroad out outside 
uteglömma 		forget 
utgift 		edition 
utgivare 		publisher 
utgång 		exit way out 
uthyra 		let rent out 
utland 		foreign country 
utlägga 		account for explain 
utländsk 		alien foreign 
utlänning 		foreigner 
utlåtande 		account record report 
utnöta 		use up wear out 
utom 		apart from but except other than 
utomlands 		abroad 
utomordentlig 		extraordinary formidable 
utpeka 		indicate suggest 
utplåna 		exterminate wipe out 
utrikes 		abroad 
utrymme 		room space 
uträkna 		calculate count figure work out 
utsikt 		view 
utskicka 		broadcast 
utställa 		exhibit 
utställning 		exhibition exposition 
uttryck 		expression 
uttrycka 		express 
utvandra 		emigrate 
utöver 		apart from besides except except for 
uv 		eagle owl 
vaccin 		vaccine 
vaccinera 		vaccinate 
vacker 		beautiful fine handsome lovely 
vad 		calf 
vada 		wade 
vadd 		cotton‐wool wadding 
vakna 		wake wake up 
vakta 		guard keep look after watch over 
vaktare 		guard 
vaktmästare 		waiter 
val 		whale 
valakt 		choice election 
valfisk 		whale 
vall 		dike embankment 
vallmo 		poppy 
vallon 		Walloon 
valnöt 		walnut 
valör 		value worth 
vampyr 		vampire 
vana 		custom habit way 
vanilj 		vanilla 
vanlig 		accustomed customary used to usual wonted 
vansinne 		craziness insanity lunacy madness 
vansinnig 		crazy insane mad nuts 
vantro 		superstition 
vantrogen 		superstitious 
vanvett 		craziness insanity lunacy madness 
vapen 		weapon 
vapenlös 		unarmed 
var 		where 
vara 		be 
varandra 		each other one another 
varann 		each other one another 
varannan 		each other one another 
vara borta 		be absent be missing 
vara enig med 		agree with 
vara ense med 		agree with 
vara rädd 		be afraid of fear 
vara rädd för 		be afraid of fear 
vara släkt med 		be related to 
vara tokig i 		be fond of love 
vardera 		both 
varelse 		creature 
varg 		wolf 
vargböna 		lupine 
varghona 		she‐wolf 
varginna 		she‐wolf 
variera 		vary 
varifrån 		from where whence 
varjehanda 		all sorts all sorts of miscellaneous of all sorts 
varken ... eller 		neither ... nor 
varlig 		careful cautious 
varligen 		careful cautious 
varm 		warm 
varna 		caution warn 
vars 		of which which one's whose 
varsam 		careful cautious 
varsel 		indication omen portent precursor presage sign 
varsko 		caution warn 
varsla 		forecast foretell prophesy 
varsågod 		please 
vas 		vase vessel 
vatten 		water 
vattenfall 		waterfall 
vax 		wax 
ve 		woe 
veck 		fold 
vecka 		fold 
veckoslut 		week‐end 
ved 		firewood 
vedernamn 		byname nickname sobriquet 
vedersakare 		adversary opponent 
vek 		soft 
vekhet 		mellowness softness tenderness 
ventil 		tube valve 
veranda 		porch veranda 
verb 		verb 
verk 		job work 
verka 		work 
verktyg 		agent means tool 
vermut 		vermouth 
vessla 		weasel 
veta 		know know how 
vete 		wheat 
vetenskap 		science 
vetenskaplig 		scientific 
vetenskapsman 		scientist 
veterlig 		well‐known 
vettig 		sagacious sage wise 
vettlös 		foolish 
vi 		us we 
vid 		at beside by near nearby near to next to 
vidd 		width 
vide 		willow 
vidskepelse 		superstition 
vidskeplig 		superstitious 
vidunder 		miracle 
vidunderlig 		miraculous 
vik 		bay 
viking 		viking 
vikt 		weight 
viktig 		important serious 
vila 		repose rest 
vild 		savage wild 
vildsint 		savage wild 
vildsvin 		wild boar 
vilja 		be willing to want wish 
vin 		wine 
vinbär 		currant 
vind 		wind 
vindruva 		grape 
vinge 		wing 
vinst 		gain profit 
vinstock 		vine grapevine 
vinter 		winter 
vinterlig 		winter winter‐ of the winter 
viol 		violet 
violin 		violin 
violoncell 		cello 
virvelvind 		cyclone 
visa 		song 
visdom 		wisdom 
vishet 		wisdom 
visit 		visit 
viska 		whisper 
visshet 		certainty 
visum 		visa visé 
vit 		white 
vite 		fine 
vits 		gag joke 
viva 		primrose 
vi ses 		bye goodbye so long 
volt 		Volt 
volym 		volume 
vred 		angry cross 
vredgad 		angry cross 
vrida 		turn turn around turn round 
vriden 		crazy insane mad nuts 
vräka 		throw 
vulkan 		volcano 
vuxen 		adult full‐grown 
vy 		appearance aspect look sight view 
vykort 		picture postcard 
väcka 		arouse wake awaken wake up 
väckarur 		alarm alarmclock 
väder 		weather 
vädur 		ram tup 
väg 		road route way 
vägg 		wall 
vägkorsning 		cross roads 
vägledare 		guide 
vägmöte 		cross roads 
vägra 		refuse reject 
vägran 		refusal 
väktare 		guard 
väl 		okay well 
välkommen 		welcome 
välsigna 		bless 
välsignelse 		blessing boon 
vämjelse 		disgust nausea 
vän 		friend 
vända 		turn turn around turn round 
väninna 		friend 
vänlig 		affable friendly good‐natured kind 
vänskap 		friendship 
vänskaplig 		friendly 
vänster 		left 
vänta 		abide expect wait await wait for 
väntan 		acuity advertence advertency attention 
vänta sig 		abide expect wait await wait for 
väntrum 		waiting‐room waiting room 
väntsal 		waiting‐room waiting room 
väpna 		arm 
väppling 		clover shamrock trefoil 
värd 		host innkeeper landlord 
värde 		value worth 
värdelös 		worthless 
värdera 		appraise estimate rate 
värderingsman 		appraiser 
värdesätta 		appreciate 
värdig 		deserving worthy 
värdinna 		hostess landlady 
värdshus 		hostel inn 
värja 		defend 
värk 		ache pain 
värld 		world 
världrymd 		universe 
världsalltet 		universe 
världsdel 		continent mainland 
världskropp 		heavenly body 
världsstad 		metropolis 
värme 		warmth 
värn 		defence defense 
värna 		defend 
väsen 		ado din noise 
väst 		west West 
väster 		west West 
västlig 		western 
västra 		western 
vätebomb 		H‐bomb hydrogen bomb 
vätska 		liquid 
väv 		fabric textile 
väva 		weave 
växa 		accrue grow 
växla 		change turn 
våda 		danger peril 
vådlig 		dangerous 
våffla 		waffle 
våga 		be bold dare 
våning 		floor storey story 
vår 		our 
vård 		monument 
vårda 		attend nurse tend to 
vårdare 		nurse 
vårta 		nipple 
våt 		wet 
xylofon 		xylophone 
ylle 		wool 
ynnest 		favor favour 
yoghurt 		yoghourt yoghurt 
yrke 		branch compartment department pigeonhole section speciality 
yxa 		chop cut hack 
zenit 		zenith 
zigenare 		gypsy Gypsy 
zink 		zinc 
zon 		zone 
zoologi 		zoology 
Österrike 		Austria 
Östersjön 		Baltic Sea 
äckel 		disgust nausea 
ädel 		noble 
ädelsten 		gem jewel 
ädling 		nobleman 
äga 		own possess 
ägare 		owner 
ägg 		egg 
äggtoddy 		egg nog 
ägna 		dedicate devote 
äkta maka 		wife 
äkta make 		husband 
äkta par 		couple married people 
äktenskap 		marriage 
älg 		elk moose 
älska 		love 
älskare 		lover 
älskarinna 		lover 
älskling 		darling 
älv 		river 
älva 		elf 
ämbete 		function job office post 
ämbetsman 		officer official 
än 		than 
ända 		accomodate end finish terminate 
ände 		end ending 
ändlig 		final 
ändlös 		everlasting 
ändock 		accordingly so then therefore 
ändra 		alter change 
ändring 		alteration change conversion transformation 
ändå 		accordingly so then therefore 
äng 		meadow 
ängd 		region 
ängel 		angel 
änka 		widow 
änkeman 		widower 
änkling 		widower 
ännu 		still yet 
äppelkaka 		apple‐tart 
äppelmos 		apple‐sauce 
äppelträd 		apple‐tree 
äpple 		apple 
ära 		era 
ärftlig 		hereditary 
ärkebiskop 		archbishop 
ärkeängel 		archangel 
ärlig 		above‐board honest 
ärm 		sleeve 
ärr 		scar 
ärt 		pea 
ärta 		pea 
ärva 		inherit 
ätbar 		edible 
ätlig 		edible 
ättika 		vinegar 
äventyr 		adventure 
äventyra 		hazard risk venture 
äventyrlig 		adventurous 
ö 		island 
öda 		waste 
ödemark 		desert 
ödla 		lizard 
ödsla 		waste 
öga 		eye 
ögonblick 		instant moment 
ögonbryn 		brow eyebrow 
ögonlock 		eyelid 
ögonläkare 		oculist ophtalmologist 
öken 		desert 
ökländ 		of ill repute 
öl 		ale beer 
ömse 		both 
önska 		desire wish 
önskan 		desire want wish 
öra 		ear 
örn 		eagle 
östan 		east East 
öster 		east East 
österländsk 		eastern Oriental 
östlig 		eastern Oriental 
östra 		eastern Oriental 
öva 		exercise practise 
över 		about concerning on upon 
överallt 		all about everywhere 
överbevisa 		convince persuade 
överenskommelse 		accord accordance agreement concurrence 
överenstämmelse 		accord accordance agreement concurrence 
överman 		chief superior 
överraskning 		surprise 
överste 		colonel 
överstiga 		exceed surpass 
översätta 		translate 
översättning 		translation 
övertro 		superstition 
överträffa 		exceed surpass 
övertyga 		convince persuade 
övertygelse 		belief conviction 
övertäcka 		cover 
övertänka 		think think about reflect on 
övlig 		accustomed customary used to usual wonted 
övning 		exercise practice 
å 		stream 
åder 		vein 
ådra 		vein 
åh 		ah oh ow 
åhörare 		listener 
åhöra 		listen 
åka 		go ride travel 
åkalla 		appeal to invoke 
åkdon 		vehicle 
åker 		field 
åkerbruk 		agriculture farming tillage 
ål 		eel 
ålder 		age 
ålderdom 		age 
ångest 		fright 
ångra 		be sorry about regret 
ånyo 		afresh again all over again anew 
år 		year 
åra 		oar 
århundrade 		centennial century 
årstid 		season 
åse 		attend be present witness 
åsikt 		opinion 
åska 		thunder 
åsna 		ass donkey 
åsninna 		jenny‐ass she‐ass 
åtal 		accusal accusation 
åter 		afresh again once more 
återbetala 		repay 
återgälda 		repay 
åtlyda 		obey 
åtlöje 		laughter 
åtta 		eight 
åtti 		eighty 
åttio 		eighty 
åttonde 		eighth 
