

beni/eyim bin ich / I am !
seni er sein (shen@kartvelian)
onu/-sin on (man@french) ğ“†‘
bizi wir sind? note familiar -zi plural
sizi sie sind! note familiar -zi plural
onlarÄ± on/leur

grammatical forms are very mixed but can still be recognised

Conditional -se "if only" â‡” si, whether ğ“‡‹ğ“‚‹ wÃ¤hre fir forâ€¦
Inferential -miÅŸ "seems" ğ“‡
Past -di "walked"
Negative -me "mano" ğ“…“ğ“‚œğ“…±
Positive -ier ğ“‚» ğ“˜ğ“²ğ“€ ja sein ğ“ƒ¹ğ“ˆ– being ğ“ƒ€
Necessitative -meli must-I â‡” é©¬ mwahri ğ“™ Â«true?Â» vs 'really' Ø®ÛŒÙ„ÛŒ

Interrogative particle mi is linked to Negative. German: ne? asiatic ma? é©¬mÇ?

Afrika 		Afrika 
AfrikalÄ± 		afrikanisch 
Alman 		deutsch 
Almanya 		Deutschland 
Amerika 		VereinigtenStaaten 
AmerikalÄ± 		amerikanisch 
Amerikan timsahÄ± 		Alligator 
Anadolu 		Anatolien 
Ankara 		Ankara 
Arap 		Araber 
Arjantin 		Argentinien 
Arnavut 		albanesisch albanisch 
Arnavutluk 		Albanien 
Asya 		Asien 
Atlas Okyanusu 		AtlantischerOzean 
AvrupalÄ± 		europÃ¤isch 
Avustralya 		Australien 
AvustralyalÄ± 		australisch 
Avusturya 		Ã–sterreich 
AvusturyalÄ± 		Ã¶sterreichisch 
BelÃ§ika 		Belgien 
BelÃ§ikalÄ± 		belgisch 
BirleÅŸik Devletler 		VereinigtenStaaten 
Brezilya 		Brasilien 
BrezilyalÄ± 		brasilianisch 
Britanya 		Britannien 
Bulgaristan 		Bulgarien 
Cezayir 		Algerien 
Cezayirli 		algerisch 
Danimarka 		DÃ¤nemark 
DanimarkalÄ± 		DÃ¤ne 
Filistin 		PalÃ¤stina 
Fransa 		Frankreich 
FransÄ±z 		franzÃ¶sisch 
HabeÅŸistan 		Ã„thiopien 
Hindistan 		India Indien 
Hintli 		Inder 
Hollanda 		Holland 
HollandalÄ± 		hollÃ¤ndisch 
HÄ±ristiyan 		Christ 
Japonca 		japanisch 
JaponyalÄ± 		japanisch 
Kanada 		Kanada 
KanadalÄ± 		kanadisch 
KÄ±brÄ±s 		Zypern 
KÄ±brÄ±slÄ± 		Zypriot 
KÄ±zÄ±lderili 		Indianer 
Macaristan 		Ungarn 
Musevi 		Jude 
MÃ¼slÃ¼man 		Mohammedaner 
MÄ±sÄ±r 		Ã„gypten 
MÄ±sÄ±rlÄ± 		egyptisch 
Noel 		Weihnachten 
NorveÃ§ 		Norwegen 
NorveÃ§ce 		Norweger 
NorveÃ§li 		norwegisch 
Paskalya 		Ostern 
Polonya 		Polen 
PolonyalÄ± 		polnisch 
Portekiz 		Portugal 
Portekizli 		portugiesisch 
Ren 		Rhein 
Rumanya 		RumÃ¤nien 
Rumca 		Grieche 
Rus 		Russe 
Rusya 		RuÃŸland 
RusÃ§a 		russisch 
Suriyeli 		syrisch 
TÃ¼rkiye 		TÃ¼rkei dieTÃ¼rkei 
Yahudi 		Jude 
Yugoslavya 		Jugoslawien 
Yunanistan 		Griechenland 
YunanlÄ± 		griechisch 
abes 		abgeschmackt absurd ungereimt widersinnig 
abide 		Denkmal Monument 
abla 		Schwester 
abluka 		Blockade 
abluka etmek 		blockieren 
abone 		Abonnement 
abuk sabuk 		Gallimathias Unsinn 
acayip 		befremdend kurios seltsam sonderbar wunderlich 
acele 		geschwind hurtig rasch schnell ++ 
acemi 		Novize 
acente 		Agent GeschÃ¤ftsbesorger +
acÄ± 		acid bitter ++
aciz 		flau gelinde schwach 
acÄ±klÄ± 		ergreifend 
acÄ±mak 		ache-make: Schmerzverursachen schmerzen wehtun ++
acÄ±kmak 		ache-make^: bedauern 
ad 		Name 
ada 		Eiland Insel 
adam 		Mensch 
adres 		Adresse 
af 		Amnestie Begnadigung StraferlaÃŸ 
akasya 		Akazie 
akordeon 		Ziehharmonika 
akrobat 		Akrobat 
aktÃ¶r 		Schauspieler 
akustik 		Akustik 
akvaryum 		Aquarium 
akÃ¼mÃ¼latÃ¶r 		Akkumulator 
akÅŸam 		Abend 
akÄ±l 		Gehirn Hirn 
alay 		Ironie 
alaÅŸÄ±m 		Legierung 
albay 		Oberst 
albÃ¼m 		Album 
alev 		Flamme 
aleyhinde 		an gegen gegenÃ¼ber wider 
alfabe 		Alphabet 
alkiÅŸ 		Applaus Beifall 
alkol 		Alkohol Spiritus 
alkÄ±ÅŸlamak 		applaudieren Beifallspenden 
almak 		fassen nehmen 
almanak 		Almanach 
altÄ± 		sechs 
alÃ¼minyum 		Aluminium 
amatÃ¶r 		Amateur Liebhaber 
amerikalÄ± 		amerikanisch 
amiral 		Admiral 
amonyak 		Ammoniak 
amper 		AmpÃ¨re 
anahtar 		SchlÃ¼ssel 
anarÅŸi 		Anarchie 
anatomi 		Anatomie Zergliederungskunst 
ancak 		kaum 
anemi 		Blutarmut 
anlamak 		begreifen erfassen verstehen 
anne 		Mutter 
ansiklopedi 		EncyklopÃ¤die 
anten 		FÃ¼hler FÃ¼hlhorn 
antika 		altertÃ¼mlich antik 
apostrof 		Apostroph 
apse 		AbszeÃŸ Eiterbeule Geschwulst 
aralÄ±k 		Dezember 
aramak 		ausschauennach suchen aufsuchen 
arasÄ±nda 		unter mittenunter zwischen 
arena 		Arena Kampfplatz 
arkadaÅŸ 		Freund 
arkasÄ±ndan 		hinter 
arpa 		Gerste 
arzu 		Appetit 
arÄ± 		Biene 
arÄ± kovanÄ± 		Bienenkorb Bienenstock 
asfalt 		Asphalt Erdpech 
asker 		Armee Heer 
astronomi 		Astronomie Himmelskunde Sternkunde 
astÄ±m 		Asthma 
at 		Gaul Pferd 
ata 		Ahn Vorfahr Urahn 
atardamar 		Arterie Pulsader Schlagader 
ateÅŸ 		Feuer 
atlet 		Athlet 
atmak 		schleudern werfen 
atmosfer 		AtmosphÃ¤re 
atom 		Atom 
ay 		Mond 
ayak bileÄŸi 		KnÃ¶chel 
ayak parmaÄŸÄ± 		Zehe 
aÃ§ 		hungrig 
aÃ§gÃ¶zlÃ¼ 		unersÃ¤ttlich 
aÃ§mak 		aufmachen Ã¶ffnen 
aÃ§Ä±k 		hell licht lichtvoll 
aÃ§Ä±kgÃ¶z 		abgefeimt arglistig gerieben gewiegt gewitzigt listig schlau 
aÃ§Ä±klama 		AufklÃ¤rung AufschluÃŸ ErlÃ¤uterung 
aÃ§Ä±klamak 		darlegen einleuchten erklÃ¤ren erlÃ¤utern 
aÃ§Ä±kÃ§a 		ausdrÃ¼cklich 
aÄŸustos 		August 
baba 		VÃ¤terchen 
babacÄ±ÄŸÄ±m 		VÃ¤terchen 
baca 		Schornstein 
bagaj 		Bagage GepÃ¤ck Verpackung 
bakteriler 		Bakterie 
bakÄ±ÅŸÄ±m 		EbenmaÃŸ GleichmaÃŸ Symmetrie 
balina 		Walfisch 
balkon 		Altan Balkon 
balon 		Ballon 
balta 		Axt Beil Hacke 
balÄ±k 		Fisch 
banka 		Bank 
banyo 		Badestube 
banyo odasÄ± 		Badestube 
barbar 		Barbar 
barikat 		Barrikade Verhau 
barometre 		Barometer 
baron 		Baron Freiherr 
basil 		Bazillus 
basur 		HÃ¤morrhoiden 
battaniye 		Bettdecke Decke 
batÄ± 		Abendland Okzident Westen 
batÄ±ya ait 		westlich 
baykuÅŸ 		Eule 
bayrak 		Banner Fahne Flagge 
baÅŸka 		anderer anders sonst 
baÅŸlamak 		anbrechen anfangen beginnen 
beden 		KÃ¶rper Leib 
beden yapÄ±sÄ± 		Anatomie Zergliederungskunst 
beklemek 		gewÃ¤rtigen harren warten erwarten 
belkemiÄŸi 		RÃ¼ckgrat 
benzin 		Benzin 
beygir 		Gaul Pferd 
beyin 		Gehirn Hirn 
bez 		Tuch 
beÅŸ 		fÃ¼nf 
beÄŸenmek 		approbieren billigen genehmigen gutheiÃŸen 
biftek 		Beefsteak 
bilardo 		Billard 
bilet 		Billett Fahrkarte Karte 
bilezik 		Armband 
bilgisinde 		Adjektiv Eigenschaftswort 
bilmek 		wissen 
bina 		Bau Bauwerk GebÃ¤ude 
bir 		ein eine eins 
bira 		Bier 
birader 		Bruder 
birden fazla kadÄ±n alma 		Polygamie Vielweiberei 
biriktirmek 		sammeln einsammeln 
birlik 		Einigkeit Einheit 
bir daha 		anderer anders sonst 
bir uzvu kesmek 		abnehmen abschneiden amputieren 
bisiklet 		Fahrrad Rad Rover 
biyografi 		Biographie Lebensbeschreibung 
biyoloji 		Biologie Lebenslehre 
biz 		uns unser wir 
biÃ§ak 		Messer 
boksÃ¶r 		Boxer 
bomba 		Bombe 
boykot 		Ausperrung Boykott 
boÅŸ 		leer 
boÄŸa gÃ¼reÅŸi alanÄ± 		Arena Kampfplatz 
broÅŸÃ¼r 		BroschÃ¼re 
bugÃ¼n 		heute 
bulmak 		finden befinden erachten ermitteln vorfinden 
bulunmayÄ±ÅŸ 		Abwesenheit 
bulut 		Wolke 
bulÃ¼z 		Bluse 
burun 		Nase 
burÃ§ 		Horoskop 
buz 		Eis 
bÃ¶brek 		Niere 
bÃ¶lÃ¼m 		Kapitel 
bÃ¼lbÃ¼l 		Nachtigall 
bÃ¼tÃ¼n 		alles 
bÃ¼yÃ¼k 		groÃŸ 
bÃ¼yÃ¼k elÃ§i 		Botschafter Gesandter 
bÃ¼yÃ¼k kilise 		Dom Kathedrale MÃ¼nster 
bÃ¼yÃ¼k zil 		Zimbel 
bÄ±rakmak 		abreisen fortgehen 
cadde 		StraÃŸe 
cambaz 		Akrobat 
cami 		Moschee 
cebir 		Algebra Buchstabenrechnung 
cephane 		Munition 
cevap 		Antwort 
cevap vermek 		antworten beantworten entgegnen erwidern 
ceviz 		WalnuÃŸ 
ceylan 		Gazelle 
coÄŸrafya 		Erdbeschreibung Erdkunde Geographie 
cuma 		Freitag 
cumartesi 		Sabbat 
cÃ¼mle kuruluÅŸu 		Syntax 
da 		auch ebenfalls gleichfalls 
daha iyi 		besser 
daha ÅŸimdiden 		bereits schon 
dahi 		auch ebenfalls gleichfalls 
daima 		allemal allzeit fortwÃ¤hrend immer jederzeit stets 
daire 		Kreis 
damat 		Eidam Schwiegersohn 
dana 		Kalb 
dans 		Tanz 
dans etmek 		tanzen 
dar 		schmal 
darÄ± 		Mais 
daÄŸ 		Berg 
de 		auch ebenfalls gleichfalls 
demek 		erwÃ¤hnen sagen 
demir 		Eisen 
demirci 		Schmied 
deri 		Leder 
deve 		Kamel 
difteri 		Diphtherie 
dikenli Ã§alÄ± 		Dorn Grat Stachel 
diktatÃ¶r 		Diktator 
dilenci 		Bettler 
dimaÄŸ 		Gehirn Hirn 
dinamit 		Dynamit 
dinlemek 		anhÃ¶ren horchen aushorchen zuhÃ¶ren 
dinsizlik 		Atheismus AtheÃ¯smus Gottesleugnung 
dip 		Boden Grund 
diploma 		Diplom PrÃ¼fungszeugnis Urkunde 
diplomat 		Diplomat 
dirsek 		Ellbogen 
diyalog 		Dialog ZwiegesprÃ¤ch 
diz 		Knie 
diÄŸer bir 		anderer anders sonst 
dokuz 		neun 
dolar 		Dollar 
domuz 		Schwein 
domuz eti 		Schweinefleisch 
domuz pastarmasÄ± 		Speck 
dondurma 		Eis Gefrorenes Speiseeis 
doÄŸru 		akkurat genau 
doÄŸu 		Orient Osten 
doÄŸum 		Geburt 
doÄŸum gÃ¼nÃ¼ 		Geburtstag 
doÄŸuya ait 		Ã¶stlich 
duka 		Herzog 
durmak 		halten anhalten Haltmachen stocken stoppen 
dÃ¶rt 		vier 
dÃ¼k 		Herzog 
dÃ¼kkÃ¢n 		Butike GeschÃ¤ft Kramladen Laden 
dÃ¼lger 		Zimmermann 
dÃ¼n 		gestern 
dÃ¼nya 		Welt 
dÃ¼zenlemek 		arrangieren einrichten ordnen anorden veranstalten 
dÃ¼ÅŸmek 		fallen 
dÃ¼ÅŸÃ¼nmek 		denken 
ecnebi memlekette 		Ausland 
ekim 		Oktober 
ekmek 		Brot 
elbise 		Kleider 
elektrik 		ElektrizitÃ¤t 
elma 		Apfel 
emniyet 		Polizei 
engel 		Barriere Schranke 
erkek 		Mann 
erkek kardeÅŸ 		Bruder 
eski 		Exâ€ 
etmek 		anfertigen herstellen leiten machen tun zurÃ¼cklegen 
evet 		ja doch 
ev kadÄ±nÄ± 		FraudesHauses 
eylÃ¼l 		September 
eÅŸ 		Frau Gemahlin 
eÅŸek 		Esel 
eÅŸkiya 		Bandit RÃ¤uber 
eÅŸlik etmek 		begleiten 
eÄŸer 		falls insofern wenn wofern 
eÄŸlendirmek 		amÃ¼sieren belustigen ergÃ¶tzen unterhalten 
fakat 		aber allein dagegen sondern 
falÄ± 		Horoskop 
fare 		Maus 
fark 		Unterschied 
fasulye 		Bohne 
felaket 		Katastrophe 
fena 		bÃ¶se schlecht 
feshetmek 		annullieren fÃ¼r null und nichtig erklÃ¤ren kassieren 
fikir 		Gedanke Idee Vorstellung 
fikir vermek 		raten beraten ratgeben 
fil 		Elefant 
fildiÅŸi 		Elfenbein 
fizik 		Physik 
formÃ¼l 		Formel 
fren 		Bremse 
fÄ±kra 		Anekdote 
fÄ±ndÄ±k 		NuÃŸ 
fÄ±rÄ±ncÄ± 		BÃ¤cker 
fÄ±rÄ±nda piÅŸirmek 		backen 
fÄ±skiye 		Brunnen Fontaine FontÃ¤ne Springbrunnen 
gaga 		Schnabel 
gazeteci 		Journalist 
gece 		Nacht 
gelmek 		kommen 
gemi 		Boot 
genelev 		Bordell 
geniÅŸlik 		Breite 
geometri 		Geometrie 
geriye doÄŸru 		zurÃ¼ck 
getirmek 		bringen anbringen eintragen heranbringen Ã¼berbringen 
girmek 		eintreten 
gitmek 		fahren gehen treten 
gri 		grau 
grup 		Gruppe 
gÃ¶bek 		Bauch Unterleib 
gÃ¶ndermek 		schicken senden einsenden 
gÃ¶rmek 		sehen ansehen 
gÃ¶vde 		KÃ¶rper Leib 
gÃ¼n 		Tag 
gÃ¼ndem 		Agenda Notizbuch 
gÃ¼ndÃ¼z 		Tag 
gÃ¼rÃ¼ltÃ¼ 		Aufsehen Braus 
gÃ¼ve 		Motte 
gÃ¼zel 		hÃ¼bsch schÃ¶n 
gÃ¼zel koku 		Aroma Duft 
gÃ¼Ã§ 		Energie Tatkraft Willenskraft 
haber vermek 		ankÃ¼ndigen anzeigen avisieren melden anmelden verkÃ¼nden 
hafta 		Woche 
halihazÄ±rda 		bereits schon 
halita 		Legierung 
hareket 		Handlung Tat 
hasÄ±rdan yapÄ±lmÄ±ÅŸ 		Stroh 
hava 		Luft 
havaÃ® 		FÃ¼hler FÃ¼hlhorn 
havuÃ§ 		Karotte MÃ¶hre MohrrÃ¼be 
havyar 		Kaviar 
haydut 		Bandit RÃ¤uber 
hayran olmak 		bewundern 
hayvan 		Tier 
hayvanbilim 		Zoologie 
hayvansal 		Tier 
haziran 		Juni 
hece 		Silbe 
hedef 		Ziel Zweck 
hemen hemen 		beinahe fast nahezu schier ungefÃ¤hr 
her zaman 		allemal allzeit fortwÃ¤hrend immer jederzeit stets 
hesap 		Konto Rechnung 
heyet 		AusschuÃŸ Komitee 
hidrojen 		Wasserstoff 
hikÃ¢ye 		Anekdote 
hiÃ§bir yerde 		nirgends 
hiÃ§bir ÅŸey 		nichts 
horoz 		Hahn 
hortlak 		Geist Gespenst Phantom Spuk 
hoÅŸ 		behaglich herrlich genehm angenehm 
hÃ¼cum 		Anfall Angriff 
hÃ¼rmet gÃ¶stermek 		ehren beehren verehren 
hÄ±rslÄ± 		ehrgeizig 
hÄ±rsÄ±zlÄ±k 		Diebstahl 
hÄ±yar 		Gurke 
hÄ±zlandÄ±rmak 		beschleunigen 
idealist 		Idealist 
ihtiras 		Ehrgeiz 
iki 		zwei 
iklim 		Klima 
ilahi 		Hymne Lobgesang 
ilahiyat 		Theologie 
ilan 		Annonce Anzeige Inserat 
ilan etmek 		ankÃ¼ndigen anzeigen avisieren melden anmelden verkÃ¼nden 
imparator 		Imperator Kaiser 
imparatorluk 		Kaiserreich Kaisertum 
inanmak 		glauben 
inanÃ§ 		Glaube Glauben 
inek 		Kuh 
iptal etmek 		annullieren fÃ¼rnullundnichtigerklÃ¤ren kassieren 
irtifa 		HÃ¶he 
ise 		falls insofern wenn wofern 
isim 		Name 
istek 		Appetit 
istihza 		Ironie 
istiridye 		Auster 
itaat etmek 		folgen befolgen gehÃ¶rchen 
itham etmek 		anklagen beschuldigen 
iyod 		Jod 
izin vermek 		erlauben gestatten 
iÃ§ilen ÅŸey 		GetrÃ¤nk Trank 
iÃ§mek 		rauchen 
iÅŸ 		Angelegenheit Ding Sache Werk 
iÅŸitmek 		hÃ¶ren vernehmen 
iÅŸtah 		Appetit 
jeoloji 		Geologie 
kabul etmek 		annehmen empfangen genehmigen 
kafes 		Bauer KÃ¤fig 
kahve 		Kaffee 
kahverengi 		braun 
kalay 		Zinn 
kalÃ§a 		Schenkel Oberschenkel 
kan 		Blut 
kanal 		Graben Kanal 
kanarya 		Kanarienvogel 
kansÄ±zlÄ±k 		Blutarmut 
kanyak 		Kognak 
kaos 		Chaos 
kapamak 		schlieÃŸen verschlieÃŸen zumachen 
kaplan 		Tiger 
kaptan 		Hauptmann KapitÃ¤n 
kapÄ± 		Tor 
kara 		schwarz 
karaaÄŸaÃ§ 		RÃ¼ster Ulme 
karakol 		Polizeiamt Polizeiwache 
karartmak 		anschwÃ¤rzen 
karmakarÄ±ÅŸÄ±k hal 		Chaos 
karnabahar 		Blumenkohl Karfiol 
kart 		Karte Zettel 
kartal 		Adler 
kartpostal 		Postkarte 
karÅŸÄ± 		an gegen gegenÃ¼ber wider 
karÄ± 		Frau Gemahlin 
karÄ±n 		Bauch Unterleib 
karÄ±nca 		Ameise 
kas 		Muskel 
kasap 		Fleischer 
kasÄ±m 		November 
kasÄ±rga 		Wirbelwind Zyklon 
katalog 		Katalog Verzeichnis 
kategori 		Kategorie 
kat'Ã® 		akkurat genau 
kaybetmek 		verlieren 
kayÄ±k 		Boot 
kayÄ±sÄ± 		Aprikose Marille 
kaza 		Unfall 
kedÄ± 		Katze 
kelebek 		Falter Schmetterling 
kemik 		Gebein Knochen 
kent 		Ort Stadt 
kereviz 		Sellerie 
kesin 		akkurat genau 
keskin 		bitter 
kesmek 		schneiden 
kestane 		Kastanie 
keza 		auch ebenfalls gleichfalls 
keÅŸiÅŸ 		MÃ¶nch 
kil 		Lehm Ton Tonerde 
kilo 		Kilogramm 
kimya 		Chemie 
kiraz 		Kirsche 
kirli 		unlauter 
kitap 		Buch 
kitapÃ§Ä± dÃ¼kkanÄ± 		Buchhandlung 
kiÅŸla 		Kaserne 
klinik 		Klinik 
kolera 		Cholera 
koltuk 		Lehnstuhl 
komedi 		KomÃ¶die Lustspiel 
komite 		AusschuÃŸ Komitee 
komÃ¼nizm 		Kommunismus 
komÅŸu 		Nachbar 
kongre 		KongreÃŸ 
konuÅŸma 		Dialog ZwiegesprÃ¤ch 
kova 		Eimer 
koÅŸmak 		laufen 
kral 		KÃ¶nig 
kraliyet 		KÃ¶nigreich 
kristal 		Kristall 
kriz 		Krisis Krise 
krom 		Chrom 
kulak 		Ohr 
kullanmak 		anwenden benutzen brauchen gebrauchen verwenden verwerten 
kulÃ¼be 		HÃ¼tte 
kulÃ¼p 		Klub 
kum 		Sand 
kumaÅŸ 		Tuch 
kumsal 		Strand 
kurt 		Wurm 
kutsal 		heilig 
kutu 		BÃ¼chse Schachtel 
kuvvet 		Energie Tatkraft Willenskraft 
kuyruklu yÄ±ldÄ±z 		Komet Schweifstern 
kuzey 		Norden 
kuzeye ait 		nÃ¶rdlich 
kuÅŸ 		Vogel 
kuÄŸu 		Schwan 
kyruk 		BÃ¼rzel Fahne Lunte Rute Schleppe Schwanz Schweif Sterz Wedel 
kÃ¶knar 		Fichte Tanne 
kÃ¶pek 		Hund 
kÃ¶prÃ¼ 		BrÃ¼cke 
kÃ¶tÃ¼ 		bÃ¶se schlecht 
kÃ¼l 		Asche 
kÃ¼ltÃ¼r 		Kultur 
kÃ¼l tablasÄ± 		Aschenbecher 
kÃ¢tip 		Angestellte Kanzlist 
kÃ¢ÄŸÄ±t para 		Bon Schein 
kÄ±lÃ§Ä±k 		GrÃ¤te 
kÄ±lÄ±Ã§ 		Schwert 
kÄ±rlangÄ±Ã§ 		Schwalbe 
kÄ±sÄ±m 		Kapitel 
kÄ±yÄ± 		KÃ¼ste 
kÄ±z 		Tochter 
kÄ±zgÄ±n 		arg bÃ¶se 
kÄ±z evlat 		Tochter 
kÄ±Ã§ 		Boden Grund 
lahana 		Kohl 
lehÃ§e 		Dialekt Mundart 
limon 		Zitrone 
limonata 		Limonade 
maaÅŸ 		Gage Gehalt SalÃ¤r 
macera 		Angelegenheit Ding Sache Werk 
madde 		Ding 
makine 		Maschine 
manda 		BÃ¼ffel 
marangoz 		Zimmermann 
mart 		MÃ¤rz 
marul 		Kopfsalat Lattich Salat 
mavi 		blau 
maymun 		Affe 
mayÄ±s 		Mai 
melek 		Engel 
merkez 		Mittelpunkt Zentrum 
mermi 		Kugel 
mesele 		Angelegenheit Ding Sache Werk 
meslekdaÅŸ 		Amtsbruder Amtsgenosse Genosse Kollege 
mezarlÄ±k 		Friedhof Gottesacker Kirchhof 
meÅŸe 		Eiche 
millet 		Nation 
milyar 		Milliarde 
mimar 		Architekt 
misafir 		Gast 
modern 		modern 
molekÃ¼l 		MolekÃ¼l 
motor 		Motor 
motosiklet 		Kraftfahrrad Motorrad 
muharebe 		Kampf Schlacht 
muhasebeci 		Buchrevisor 
muhteris 		ehrgeizig 
muktedir 		begabt fÃ¤hig imstande tÃ¼chtig 
mum 		Kerze Licht 
mutfak 		KÃ¼che 
muvafakat etmek 		beipflichten beistimmen einwilligen zustimmen zuwilligen 
muz 		Banane 
mÃ¼cadele 		Konflikt Streit Widerstreit 
mÃ¼hendis 		Ingenieur 
mÃ¼him 		arg bedeutend bedeutsam betrÃ¤chtlich erheblich ernst wichtig 
mÃ¼neccimlik 		Astrologie Sterndeutung 
mÃ¼saade etmek 		erlauben gestatten 
mÃ¼vekkil 		Klient Kunde 
mÃ¼ÅŸteri 		Klient Kunde 
mÄ±sÄ±r 		Mais 
mÄ±zrak 		Lanze Speer 
nakletmek 		tragen 
nalbant 		Schmied 
namevcut 		abwesend 
namus 		Ehre 
nashihat 		Rat Ratschlag 
nazari 		theoretisch 
nefes 		Atem Hauch 
nefes alma 		Atem Hauch 
nefes almak 		atmen 
nefis 		hÃ¼bsch 
nehir 		FluÃŸ 
nisan 		April 
o 		er ihm ihn seiner 
ocak ayÄ± 		Januar 
ok 		Pfeil 
oksijen 		Oxygen Sauerstoff 
okumak 		lesen 
olay 		Unfall 
olmak 		geschehen vorkommen werden zustandekommen 
on 		zehn 
on bÄ±r 		elf 
ordu 		Armee Heer 
otel 		Hotel 
otobÃ¼s 		Autobus Bus 
otomobil 		Auto 
oturmak 		sitzen 
oÄŸlan 		Junge Knabe 
oÄŸul 		Sohn 
papatya 		GÃ¤nseblÃ¼mchen kleinesMaÃŸlieb Marienblume 
para 		Geld 
pars 		Leopard 
patates 		Erdapfel Kartoffel 
patron 		Befehlshaber Chef Haupt HÃ¤upling Herr Oberhaupt Vorsteher 
pazartesi 		Montag 
pek 		sehr 
penÃ§e 		Klaue Kralle 
perde 		Gardine Vorhang 
perhiz 		DiÃ¤t 
peri 		Nymphe 
perÅŸembe 		Donnerstag 
peynir 		KÃ¤se 
pire 		Floh 
piskopos 		Bischof 
piÃ§ 		Bastard Mischling 
plaj 		Strand 
polis 		Polizei 
porsuk 		Dachs 
portakal 		Apfelsine Orange Pomeranze 
puro 		Zigarre 
pusula 		KompaÃŸ 
rahibe 		Nonne 
rejim 		DiÃ¤t 
reklam 		Annonce Anzeige Inserat 
renk 		Farbe 
ressam 		Artist 
revolver 		Revolver 
roman 		Roman 
rÃ¼zgar 		Wind 
saat 		Uhr 
sabah 		FrÃ¼he Morgen 
sabah kahvaltÄ±sÄ± 		FrÃ¼hstÃ¼ck 
sadaka 		Almosen 
sadece 		kaum 
sahil 		KÃ¼ste 
sakal 		Bart 
salata 		Kopfsalat Lattich Salat 
salatalÄ±k 		Gurke 
saldÄ±rmak 		anfallen angreifen ausfallen befallen Ã¼berfallen 
saldÄ±rÄ±ÅŸ 		Anfall Angriff 
salÄ± 		Dienstag 
saman 		Stroh 
sanatkÃ¢r 		Artist 
sandal 		Boot 
sandalye 		Stuhl 
sandviÃ§ 		Sandwich 
sanki 		alsob gleichsam 
sanmak 		vermuten voraussetzen 
santimetre 		Centimeter Zentimeter 
sarmaÅŸÄ±k 		Efeu 
sarÄ±ÅŸÄ±n 		blond 
satmak 		verÃ¤uÃŸern verkaufen 
savaÅŸ 		Krieg 
sayfa 		Folio Seite 
saymak 		zÃ¤hlen aufzÃ¤hlen 
saÃ§ma 		abgeschmackt absurd ungereimt widersinnig 
saÄŸÄ±r 		taub 
sekiz 		acht 
selvi 		Zypresse 
sembol 		Symbol 
sene 		Jahr 
sepet 		Korb 
sesli harf 		Vokal 
ses dÃ¼zeni 		Akustik 
sevmek 		gernhaben lieben mÃ¶gen 
seÃ§mek 		auslesen wÃ¤hlen auswÃ¤hlen erwÃ¤hlen 
sidik torbasÄ± 		Blase 
sigar 		Zigarre 
sigara 		Zigarette 
silah 		Gewehr 
silindir 		Walze Zylinder 
simetri 		EbenmaÃŸ GleichmaÃŸ Symmetrie 
simetrik 		symmetrisch 
sincap 		Eichhorn EichhÃ¶rnchen 
sinema 		Kino 
sirk 		Zirkus 
sivrisinek 		Moskito StechmÃ¼cke 
siyah 		schwarz 
sokak 		StraÃŸe 
solucan 		Wurm 
solumak 		atmen 
som balÄ±ÄŸÄ± 		Lachs Salm 
sonbahar 		Herbst 
sonra 		hinter 
sonralarÄ± 		dann darauf hernach hierauf hinten hinterher nachher spÃ¤ter 
sormak 		fragen anfragen 
soyadÄ± 		Familienname 
soÄŸan 		Zwiebel 
sporcu 		Athlet 
su 		Wasser 
sultan 		Sultan 
susuzluk 		Durst 
suÃ§lamak 		anklagen beschuldigen 
suÃ§lu 		schuldig 
sÃ¶ylemek 		erwÃ¤hnen sagen 
sÃ¶z 		Vokabel Wort 
sÃ¶zcÃ¼k 		Vokabel Wort 
sÃ¼lÃ¼n 		Fasan 
sÃ¼ngÃ¼ 		Bajonett 
sÃ¼pÃ¼rge 		Besen 
sÄ±cak 		heiÃŸ 
sÄ±fÄ±r 		Null 
sÄ±gÄ±r eti 		Rindfleisch 
sÄ±nÄ±f 		Kategorie 
sÄ±ra 		Bank 
sÄ±tma 		Malaria 
takdire deÄŸer 		bewundernswert wunderbar 
takdir etmek 		applaudieren Beifallspenden 
taksi 		Taxe Taxi 
takvim 		Almanach 
tam 		akkurat genau 
tanÄ±mak 		kennen 
taparcasÄ±na sevmek 		anbeten verehren vergÃ¶ttern 
tarak 		Kamm 
taramak 		kÃ¤mmen 
tatlÄ± 		sÃ¼ÃŸ 
tavan 		Decke Zimmerdecke 
tavÅŸan 		Kaninchen 
tay 		Fohlen FÃ¼llen 
tayyare 		Ã„roplan Flugmaschine Flugzeug 
tayyare mayadanÄ± 		Flugplatz 
taÅŸÄ±mak 		tragen 
tedavi 		Therapie 
tehlike 		Gefahr 
tehlikeli 		besorglich gefÃ¤hrlich 
tekrar 		abermalig abermals vonneuem wieder 
temmuz 		Juli <<
teoloji 		Theologie + 
teorik 		theoretisch +
tepe 		Halde HÃ¼gel +
tereyaÄŸÄ± 		Butter < Taur
ter 		SchweiÃŸ sweater3 : ğ“ˆ™ ğ“‚§ ğ“‚§ ğ“ˆ’ ğ“ˆ’ ğ“ˆ’
terlemek 		schwitzen 
termometre 		Thermometer 
tertip etmek 		arrangieren einrichten ordnen anorden veranstalten 
terzi 		Schneider 
tezgÃ¢h 		Bank  Ï„ÏÎ¬Ï€ÎµÎ¶Î±
teÅŸekkÃ¼r 		danke 
tilki 		Fuchs 
timsah 		Krokodil +
tiyatro 		+ Theater 
top 		Gewehr 
toplamak 		sammeln einsammeln 
toprak 		Boden Erdboden Erde Grund Land Terrain 
tren 			train: Zug 
tugay 		Brigade 
tunÃ§ 			Tin Zink é“œ tÃ³ng :  Bronze Erz 
tutku 		Ehrgeiz 
tutkulu 	ehrgeizig 
tutmak 		halten aufhalten tot-mach;)
tuz 		Salz << tuzlu
tuzlu 		salzen salzig ++
tuÄŸla 		Ziegel via tÃ©gla(Hun) cegÅ‚a(Turk) +++  Backstein Ziegelstein 
tÃ¶ren 		Feierlichkeit FÃ¶rmlichkeit Zeremonie 
tÃ¼fek 		Gewehr 
tÄ±rmanmak 		klettern klimmen 
tÄ±rtÄ±l 		Raupe 
ufuk 		gesichtskreis Horizont 
ulus 		Nation 
ulusal 		national 
ummak 		hoffen 
umut 		Hoffnung 
unutmak 		vergessen 
uygun 		behaglich herrlich genehm angenehm 
uyumak 		schlafen 
uzak 		entlegen fern entfernt weit 
uÃ§ak 		Ã„roplan Flugmaschine Flugzeug 
uÃ§aklar 		Flugzeug 
uÃ§mak 		fliegen huschen 
vapur 		Dampfer 
varil 		FaÃŸ Tonne 
varÄ±ÅŸ 		Ankunft Eintreffen 
ve 		und 
vermek 		erteilen geben angeben herreichen 
vestiyer 		Garderobe 
virgÃ¼l 		Apostroph 
viski 		Whisky 
volkan 		Vulkan 
vÃ¼cut 		KÃ¶rper Leib 
yaban eÅŸeÄŸi 		Zebra 
yakÄ±nda 		bald alsbald baldig 
yalan 		flunkern lÃ¼gen belÃ¼gen 
yalnÄ±z 		allein alleinig bloÃŸ einzig 
yamyam 		Kannibale Menschenfresser 
yapmak 		anfertigen herstellen leiten machen tun zurÃ¼cklegen 
yat 		Jacht Yacht 
yatak 		Bett Bettstelle 
yatak odasÄ± 		Schlafzimmer 
yavru kedi 		KÃ¤tzchen 
yazar 		Autor Urheber Verfasser 
yazmak 		schreiben 
yaÅŸ 		Alter 
yaÅŸamak 		leben 
yaÄŸ 		Ã–l 
yedi 		sieben 
yemin 		Eid 
yeni 		neu 
yeryÃ¼zÃ¼ 		Boden Erdboden Erde Grund Land Terrain 
yetiÅŸkin 		gedeihen wachsen anwachsen 
yeÅŸil 		grÃ¼n 
yeÄŸen 		Nichte 
yine 		abermalig abermals vonneuem wieder 
yokluk 		Abwesenheit 
yollamak 		schicken senden einsenden 
yulaf 		Hafer 
yumurta 		Ei 
yunus baliÄŸÄ± 		Delphin TÃ¼mmler 
yÃ¼ksek okul 		Kollegium 
yÃ¼n 		Wolle 
yÃ¼rÃ¼mek 		gehen laufen marschieren treten 
yÃ¼z 		hundert 
yÃ¼zmek 		schwimmen 
yÃ¼zÃ¼nden 		da denn weil 
yÄ±ldÄ±z 		Horoskop 
yÄ±llÄ±k 		Almanach 
zabÄ±ta 		Polizei 
zambak 		Lilie 
zarf 		Adverb Umstandswort 
zarif 		elegant geschmackvoll 
zar zor 		kaum 
zebra 		Zebra 
zehir 		Gift 
zeki 		abgefeimt arglistig gerieben gewiegt gewitzigt listig schlau 
zeytin 		Olive 
zincir 		Kette 
zooloji 		Zoologie 
zÃ¼rafa 		Giraffe 
Ã¶fkeli 		arg bÃ¶se 
Ã¶ldÃ¼rmek 		ermorden tÃ¶ten 
Ã¶lmek 		sterben 
Ã¶lmÃ¼ÅŸ 		gestorben tot verstorben 
Ã¶lÃ¼ 		gestorben tot verstorben 
Ã¶rdek 		Ente 
Ã¶rÃ¼mcek aÄŸÄ± 		Spinngewebe 
Ã¶zel 		spezial speziell 
Ã¶zerklik 		Autonomie Selbstgesetzgebung 
Ã¶ÄŸleden sonra 		Nachmittag 
Ã¶ÄŸrenmek 		lernen 
Ã¶ÄŸÃ¼t 		Rat Ratschlag 
Ã¶ÄŸÃ¼t vermek 		raten beraten ratgeben 
Ã¼lkÃ¼cÃ¼ 		Idealist 
Ã¼niversite 		Hochschule UniversitÃ¤t 
Ã¼stÃ¼ne evlenme 		Bigamie 
Ã¼Ã§ 		drei 
Ã‡in 		China 
Åeytan 		Satanas Teufel 
Ã§akÄ± 		Messer 
Ã§alar saat 		Wecker 
Ã§aliÅŸmak 		arbeiten 
Ã§alÄ±ÅŸkan 		beflissen emsig fleiÃŸig geflissentlich strebsam 
Ã§aprazvari 		jenseits quer Ã¼ber hinÃ¼ber 
Ã§arÅŸamba 		Mittwoch 
Ã§arÅŸÄ± 		Basar Markt Warenhaus 
Ã§ay 		Tee 
Ã§ek 		Bankanweisung Scheck 
Ã§ekmek 		ziehen verziehen 
Ã§ene 		Kiefer Kinnlade 
Ã§eÅŸme 		Brunnen Fontaine FontÃ¤ne Springbrunnen 
Ã§ikolata 		Schokolade 
Ã§ilek 		Erdbeere 
Ã§imento 		Zement 
Ã§ingene 		Zigeuner 
Ã§inko 		Zink 
Ã§iplak 		bloÃŸ nackt 
Ã§iÄŸnemek 		kauen 
Ã§ok beÄŸenmek 		bewundern 
Ã§ok geÃ§meden 		bald alsbald baldig 
Ã§orba 		Suppe 
Ã§oÃ§uk 		Junge Knabe 
Ã§oÄŸulu 		Leben 
Ã§Ã¼nkÃ¼ 		da denn weil 
Ã§Ä±kmak 		ausgehen ausrÃ¼cken 
ÅŸapka 		Hut 
ÅŸarap 		Wein 
ÅŸarkÄ± 		Gesang Lied 
ÅŸehir 		Ort Stadt 
ÅŸeref 		Ehre 
ÅŸey 		Ding 
ÅŸiddetli 		bitter 
ÅŸikayet etmek 		klagen sichbeklagen verklagen 
ÅŸikÃ¢yet 		Beschwerde Klage 
ÅŸimdi 		jetzt gegenwÃ¤rtig nun 
ÅŸiÅŸe 		Flasche 
ÅŸofÃ¶r 		Chauffeur Fahrer 
ÅŸubat 		Februar 
Ä±lÄ±k 		warm 
Ä±rmak 		FluÃŸ 
Ä°ncil 		Bibel 
Ä°ngiliz 		englisch 
Ä°ngilizce 		englisch 
Ä°ngiliz kamÄ±ÅŸÄ± 		Bambus 
Ä°ngiltere 		England 
Ä°rlanda 		Irland 
Ä°rlandalÄ± 		Ire 
Ä°sa 		Christus 
Ä°slam 		Islam 
Ä°spanya 		Spanien 
Ä°spanyol 		Spanier 
Ä°srail 		Israel 
Ä°sveÃ§ 		Schweden 
Ä°sveÃ§li 		schwedisch 
Ä°sviÃ§re 		Schweiz dieSchweiz 
Ä°sviÃ§reli 		schweizerisch 
Ä°talya 		Italien 
Ä°talyan 		italienisch 
Ä°talyanca 		italienisch 
