English gloss 	Hadza	Isolated @ Tanzania
I 	*one / îone/, */-ko/[4]	one, anI
rain 	'= ''water'' (msg = ''rain, river''; mpl = ''water'')'	
tooth 	aha / îa…¶a/	
skin 	ahu / îa…¶u/	
name 	akhana / îak ∞ana/	erkenner < kern ìÇã
eye 	akhwa / îak ∑ ∞a/	augwa
blood 	athama / îat ∞ama/	adama
water 	'ati / îati/ (mpl; msg = ''rain, river'')'	wati¬Æ
fish 	ccama /‚Åø«ÄÀÄama/, ccara /‚Åø«ÄÀÄa…∫a/	ìÇã ìÖì ìÜõ ìÇª
louse 	ccamazzi /‚Åø«ÄÀÄamatÕús ºi/[2]	
to see 	ch√Æ /«Ä ∞iÀê/ ~ c√Æ /«ÄiÀê/	see
to drink 	fa /f ∑a/	'boi'''
full 	gga ºe /kÕúx‚Äôa îe/, *cco- /‚Åø«ÄÀÄo-/	kall
knee 	guringuri /…°u…∫i∆û…°u…∫i/ ~ gurunguri /…°u…∫u∆û…°u…∫i/ (Cushitic? pan-African)	'gurinee k''nee'
ear 	hajjapitchi /…¶atÕú É‚ÄôapitÕú É ∞i/[3]	
stone 	haqqa /…¶a‚Åø«ÉÀÄa/	
person 	haza /…¶adÕúza/ (human), unu / îunu/ (person)	
leaf 	hazzape /…¶atÕús‚Äôape/	
bark 	heggwa /…¶ekÕúx ∑‚Äôa/	
nose 	intawe / îi∆ût ∞awe/	
breast 	'iriba / îi…∫iba/ (''breasts, milk''. Cushitic); ggazza /kÕúx‚ÄôatÕús‚Äôa/ (''flesh at sternum'')'	
sun 	isho / îi Éo/	
one 	itch√¢me / îitÕú É ∞aÀême/	
bone 	midla /micÕú éÃ•Àî‚Äôa/ (cf. Dahalo)	
tongue 	ncata /‚Åø«Äata/	
star 	ntsa /∆ûtÕús ∞a/, sa /sa/ (Cushitic?)[5]	
hear 	nxa ºe /‚Åø«Åa îe/	
we (exclusive) 	√¥ / îoÀê/, /-j-/	
two 	piye /pie/, konxa /ko‚Åø«Åa/ (verb)	bi
horn 	roo /…∫o îo/	hroo(n)
to die 	taxxi /ta‚Åø«ÅÀÄi/, misi /misi/ (Datooga?)	misi < mut
thou 	the /t ∞e/, /-en-/ (m), /-n-/ (f)	(an) thee
hand, arm 	ukhwa / îuk ∑ ∞a/	u khwand
dog 	xhaano /«Å ∞a îano/, t√Ængi /tiÀê∆ûki/	chien
kill 	x√¥ /«ÅoÀê/	
liver 	xxe /‚Åø«ÅÀÄe/	
mountain 	xxudle /‚Åø«ÅÀÄucÕú éÃ•Àî‚Äôe/	
path 	yeke /jeke/	
come 	za /dÕúza/ (Bantu), botco /botÕú Éo/ (stem of imperative)	
new 	zana /dÕúzana/[6]	xin ìå≥ ìÖ±
night 	'zzifi /tÕús‚Äôifi/ (m; f = ''day'')'	
tree 	zziti /tÕús‚Äôiti/	
fire 	zzoko /tÕús‚Äôoko/	
