
Malayalam (/mÊŒlÉ™ËˆjÉ‘ËlÉ™m/;[5] à´®à´²à´¯à´¾à´³à´‚, MalayÄá¸·am ? [mÉlÉ™jaËÉ­É™m]) is a Dravidian language 
Not to be confused with Malay language.
Native speakers 38 million
Ethnicity 	Malayalis,Keralites

Vater 
PIE
ğ±ğ¡ğ«ğ 			PiTa	
à¤ªà¤¿à¤¤à¤¾ m (pitÄ)
à´ªà´¿à´¤à´¾à´µàµ (pitÄv) Malayalam
Armenian: Õ°Õ¡ÕµÖ€ (hy) (hayr), ÕºÕ¡ÕºÕ¡ (hy) (papa informal) 
Assamese: à¦ªà¦¿à¦¤à¦¾ (pita)
Asturian: padre (ast) m, pÃ¡ (ast) m
Avestan: ğ¬ğ¬Œğ¬™ğ¬€ğ¬­ (pitar)

PIE: Ph.Tr
I18N PAPA BABA
SLAVIC: OTEC
SEM	 ABA
MALAY? RAMA
Turk ATA TATA DADA
Amerikan?  DADA  Cherokee: á¡á™á“ (edoda), á á“á™á“ (adadoda)

PIE:
Saterland Frisian: Baabe
Scottish Gaelic: athair (gd) !!! VS Turk!
Walloon: pere (wa) m
North Frisian:
    FÃ¶hr-Amrum: aatj m WTF <> Coptic
    Hallig: baabe m
    Mooring: tÃ¤Ã¤te m  WTF

FOREIGN:
Turkmen: kaka !
Nivkh: Ñ‹Ñ‚Ğº (ytk), Ñ‹Ñ‚Ñ‹Ğº (ytyk), Ñ‹Ñ‚ĞºĞ° (ytka), Ñ‹Ñ‚Ñ‹ĞºĞ° (ytyka)
O'odham: oê‰g <?>
Northern Sami: Ã¡hÄÄi
Old East Slavic: Ğ¾Ñ‚ÑŒÑ†ÑŒ m (otÄ­cÄ­)
Pitjantjatjara: mama, punari
Polish: ojciec (pl) m pers, tata (pl) m pers (familiar; equivalent of "dad") <> PIE
Votic: isÃ¤
VÃµro: esÃ¤
Russian: 
1) Ğ¾Ñ‚ĞµÌÑ†  m (otÃ©c),   SLAV
2) Ñ‚ÑÌÑ‚Ñ  m (tjÃ¡tja) TURK
3) Ğ¿Ğ°ÌĞ¿Ğ°  m (pÃ¡pa) PIE
... , Ğ±Ğ°ÌÑ‚Ñ  m (bÃ¡tja) , Ğ±Ğ°ÌÑ‚ÑÑˆĞºĞ°  m (bÃ¡tjuÅ¡ka), Ğ±Ğ°ÌÑ‚ÑŒĞºĞ°  m (bÃ¡tÊ¹ka), Ğ¿Ğ°Ğ¿Ğ°ÌÑˆĞ°  m (papÃ¡Å¡a)
Rusyn: Ğ½ÑÌĞ½ÑŒĞ¾ m (njÃ¡nÊ¹o)
Rwanda-Rundi: so (rw)
Saaroa: ama'a
Sabaean: ğ©±ğ©¨ ('b)
Saisiyat: yaba'
Welsh: tad (cy) m
ÇƒXÃ³Ãµ: aÌ°a
Yami: ama
Zulu: (my) ubaba, (your) uyihlo, (his/her) uyise
Malay: bapa, ayah (ms), bapak, ayahanda, rama, abah (ms)
West Frisian: heit (fy), (archaic or phrasal) faar !!!
Vietnamese: () ba (vi), cha (vi), tÃ­a (vi), tháº§y (vi), cáº­u (vi), (Northern) bá»‘ (vi), bÃ¡c (vi), bá» (vi), Ã¡ng (vi)
Talysh: Asalemi: Ø¯Ø¯Ù‡ (dada)
Tamil: à®…à®ªà¯à®ªà®¾ (ta) (appÄ), à®¤à®¨à¯à®¤à¯ˆ (ta) (tantai), à®…à®¤à¯à®¤à®©à¯ (ta) (attaá¹‰), à®…à®ªà¯à®ªà®©à¯ (ta) (appaá¹‰)
Taos: tÇ«ÌmÃ©na
Taroko: tama
Tatar: Ğ°Ñ‚Ğ° (tt) (ata), Ó™Ñ‚Ğ¸ (tt) (Ã¤ti), Ğ°Ñ‚Ğ°Ğ¹ (atay)
Telugu: à°¨à°¾à°¨à±à°¨ (te) (nÄnna), à°¤à°‚à°¡à±à°°à°¿ (te) (taá¹ƒá¸ri)
Tetum: aman
Thai: à¸à¹ˆà¸­ (th) (pÉ”Ì‚É”), à¸šà¸´à¸”à¸² (th) (bÃ¬-daa)
Thao: ama
Tibetan: à½”à¼‹à½• (pa pha), à½•à¼‹à½£à½‚à½¦ (pha lags) (honorific)
Tuvan: Ğ°Ñ‡Ğ° (aÄa), Ğ°Ğ´Ğ° (ada)
TÃ y: å—“, å—š, å—Ÿ
Udmurt: Ğ°Ñ‚Ğ°Ğ¹ (ataj), Ğ±ÑƒĞ±Ñ‹ (buby), Ğ°Ğ¹Ñ‹ (ajy)
Upper Sorbian: nan m
Sudovian: tÄvas m
Sundanese: rama
Svan: áƒ›áƒ£ (mu)
Slovene: oÄe (sl) m, oÄka m, (dialect) tata m, (dialect) ata m
Sinhalese: à¶­à·à¶­à·Šà¶­à· (si) (tÄttÄ)
Skolt Sami: eÊ¹ÄÄ
Slovak: (formal) otec (sk), (diminutive) tato, (diminutive) tatko, (diminutive) tatÃ­Äko, (pejorative) foter
Silesian: uojÄ‡ec m
Moksha: Ğ°Ğ»Ñ (alja)
Mongolian: Ğ°Ğ°Ğ² (mn) (aav), ÑÑ†ÑĞ³ (mn) (etseg)
Muong: pá»•
Mwani: baba, wawa
Nahuatl: tahtli (nah)
Nama: ÇgÃ»b
Nataoran Amis: wama
Maori: matua taane, tÄne
Mbabaram: nganjan
Minaean: ğ©±ğ©¨ ('b)
Mingrelian: áƒ›áƒ£áƒ›áƒ (muma)
Miyako: ã‚¢ã‚µ (asa)
Maltese: missier
Mansi: ÄÑÑŒ
Manx: ayr m
Adyghe: Ñ‚Ñ‹ (tÉ™)
Ainu: ã‚¢ãƒãƒ£ (aca)
Amis: ama^
Amurdag: iraba
Arabic: Ø£ÙØ¨ (ar) m (Ê¾ab)  VS!!
Arabic: ÙˆÙØ§Ù„ÙØ¯ (ar) m (wÄlid)
Arabic: Ù…ÙÙˆÙ’Ù„ÙÙˆØ¯ Ù„ÙÙ‡Ù m (mawlÅ«d lahu)
Buryat: ÑÑÑĞ³Ñ (esege)
Cherokee: á¡á™á“ (edoda), á á“á™á“ (adadoda)
Cantonese: çˆ¶è¦ª, çˆ¶äº² (fu6 can1), çˆ¸çˆ¸ (baa1-4 baa1) (colloquial), è€ç«‡, è€çª¦, è€è±† (lou5 dau6)
Dungan: please add this translation if you can
Mandarin: çˆ¶è¦ª (zh), çˆ¶äº² (zh) (fÃ¹qÄ«n), çˆ¶ (zh) (fÃ¹), çˆ¸çˆ¸ (zh) (bÃ ba), çˆ¹ (zh) (diÄ“) (colloquial)
Min Nan: çˆ¹è¦ª (zh-min-nan), çˆ¹äº² (tia-chhin), å¨˜çˆ¸/å¨˜çˆ¶ (niÃ»-pÄ“), çˆ¶è¦ª, çˆ¶äº² (hÅ«-chhin) 

Chuukese: sam
Chuvash: Ğ°Ñ‚Ñ‚Ğµ (atte)
Comanche: apÊ‰
Coptic: Sahidic: â²‰â²“â²±â²§ m (eyÅt), â²¡â²â²§â²£â²Ÿâ²¥ m (patros), â²‰â²“â²Ÿâ²§â²‰ pl (eyote), !!!!!  *FIOTr
Coptic: Bohairic: â²“â²±â²§ m (yÅt), â²¡â²â²§â²£â²Ÿâ²¥ m (patros), â²“â²ŸÏ¯ pl (yoti),  << PJOTRE ???
<> FÃ¶hr-Amrum: aatj m WTF



QUESTIONABLE
Mandarin: çˆ¶è¦ª çˆ¶äº² (fÃ¹qÄ«n), çˆ¶ (fÃ¹), çˆ¸çˆ¸ (bÃ ba) !!
Burmese: á€¡á€–á€± (my) (a.hpe), á€¡á€– (my) (a.hpa.), (formal) á€–á€á€„á€º (my) (hpa.hkang)
Aromanian: tatÃ£ m
Aleut: adax
Egyptian Arabic: Ø£Ø¨ m (Ê¾ab), Ø¨Ø§Ø¨Ø§ m (baba), ÙˆØ§Ù„Ø¯ m (wÄled) 
Malayalam: à´…à´šàµà´›à´¨àµâ€ (acchanâ€), à´ªà´¿à´¤à´¾à´µàµ (ml) (pitÄv)
Marathi: à¤ªà¤¿à¤¤à¤¾ m (pitÄ)
Mazanderani: Ù¾ÛŒÙ‡â€ŒØ± (pier)
Mirandese: pai
Nepali: à¤¬à¤¾à¤¬à¥ (ne) m (bÄbu)
Occitan: paire (oc) m
Ojibwe: imbaabaa (my father)
Punjabi: à¨ªà¨¿à¨“ m (pio), à¨ªà¨¿à¨¤à¨¾ m (pitÄ), à¨¬à¨¾à¨ª m (bÄp)
Serbo-Croatian: Cyrillic: Ğ¾Ñ‚Ğ°Ñ† m Roman: otac (sh) m
Shona: baba
Sindhi: Ù¾ÙŠØ¡ (pÄ«Ê¾u), Ø¨Ø§Ø¨Ùˆ (bÄbÅ)
Somali: aabo (so), aabbe (so)
South Picene: ğŒğŒ€ğŒ•ğŒ„ğŒ“ğŒ„ğŒğŒ‡ (patereÃ­h)
Swahili: baba (sw), mzee (sw)
Tajik: Ğ¿Ğ°Ğ´Ğ°Ñ€ (tg) (padar), Ğ±Ğ¾Ğ±Ğ¾ (tg) (bobo)
Urdu: Ù¾ØªØ§ m (pitÄ), ÙˆØ§Ù„Ø¯ (ur) m (vÄlid), Ø¨Ø§Ù¾ m (bÄp), Ù¾Ø¯Ø± m (pidar)
Uyghur: Ø¯Ø§Ø¯Ø§ (ug) (dada), Ø¦Ø§ØªØ§ (ug) (ata)
Waneci: Ù¾ÙŠØ§Ø± (piyÄr)
Baba Malay: bapak
Baluchi: Ù¾Øª (pit), Ù¾Ø³ (pis), Ø§Ø¨Ø§ (abbÃ¡)
ã‚¢ã‚µ (asa)  
Azeri: ata (az), (dialect) dÉ™dÉ™
Bashkir: Ğ°Ñ‚Ğ°Ğ¹ (atay)
Basque: aita (eu)
Bats: áƒ“áƒáƒ“ (dad)
ğ’€œ (abu)
Ø¨Ø§Ø¨Ø§ m (baba)	Egyptian Arabic!
Aleut: adax !
Lydian: ğ¤ ğ¤¯ğ¤  (ata)
LÃ¼: á¦—á¦¸á§ˆ (pÉ”)
Pite Sami: Ã¡httje
Plains Apache: tâ€™aah (-tâ€™Ã¡â€™)


Semitic
ÙˆØ§Ù„Ø¯ m (wÄled) Egyptian Arabic
Ø£Ø¨ m (Ê¾ab)
Hebrew: ××‘× m (â€™abÄâ€™)
Syriac: ÜÜ’Ü m (â€™abÄâ€™)
Amharic: áŠ¥á‰£á‰µ m (Ê¾É™bat)
ğ€ğ€³  ğ¤€ğ¤ AB/Vat/PaTaur 
Aragonese: pai (an) m
Atayal: yaba

Foreign (dad)
Aromanian: tatÃ£ m
Avar: ÑĞ¼ĞµĞ½ (Ã¨men)
Bulgarian: Ğ±Ğ°Ñ‰Ğ°Ì (bg) m (baÅ¡tÃ¡), Ñ‚Ğ°ÌÑ‚ĞºĞ¾ (bg) m (tÃ¡tko), Ñ‚Ğ°Ñ‚Ğ¸ m (tati)
Romani: dad m
Romanian: tatÄƒ (ro) m
Latvian: tÄ“vs (lv) m, tÄ“tis m (dad), papucÄ«tis m (sexual, sarcastic)